year,country_name,wins,runnerups,total_finals_games,finals_win_rate,total_wins,total_losses,total_games,win_rate,latitude,longitude
1969,Australia,17,14,31,54.83870967741935,962,344,1306,73.66003062787136,-25.274398,133.775136
1969,Croatia,2,3,5,40,51,36,87,58.620689655172406,45.1,15.2
1969,France,1,1,2,50,93,153,246,37.80487804878049,46.227638,2.213749
1969,Netherlands,5,3,8,62.5,65,21,86,75.5813953488372,52.132633,5.291266
1969,Romania,1,2,3,33.33333333333333,49,41,90,54.44444444444444,45.943161,24.96676
1969,South Africa,2,2,4,50,166,153,319,52.03761755485894,-30.559482,22.937506
1969,Spain,3,2,5,60,90,47,137,65.69343065693431,40.463667,-3.74922
1969,United States,7,10,17,41.17647058823529,463,400,863,53.650057937427576,37.09024,-95.712891
1970,Australia,26,28,54,48.148148148148145,728,404,1132,64.31095406360424,-25.274398,133.775136
1970,Croatia,4,2,6,66.66666666666666,136,54,190,71.57894736842105,45.1,15.2
1970,Czech Republic,2,1,3,66.66666666666666,75,61,136,55.14705882352941,49.817492,15.472962
1970,Germany,1,1,2,50,77,90,167,46.10778443113773,51.165691,10.451526
1970,Netherlands,5,1,6,83.33333333333334,89,32,121,73.55371900826447,52.132633,5.291266
1970,Romania,3,2,5,60,96,43,139,69.06474820143885,45.943161,24.96676
1970,South Africa,1,4,5,20,188,181,369,50.94850948509485,-30.559482,22.937506
1970,Spain,2,4,6,33.33333333333333,122,67,189,64.55026455026454,40.463667,-3.74922
1970,United Kingdom,2,3,5,40,197,224,421,46.79334916864608,55.378051,-3.435973
1970,United States,20,16,36,55.55555555555556,667,568,1235,54.0080971659919,37.09024,-95.712891
1971,Australia,22,16,38,57.89473684210527,730,665,1395,52.32974910394266,-25.274398,133.775136
1971,Croatia,5,3,8,62.5,115,77,192,59.895833333333336,45.1,15.2
1971,Czech Republic,3,5,8,37.5,128,106,234,54.700854700854705,49.817492,15.472962
1971,Netherlands,2,4,6,33.33333333333333,74,36,110,67.27272727272727,52.132633,5.291266
1971,Romania,9,5,14,64.28571428571429,123,43,166,74.09638554216868,45.943161,24.96676
1971,South Africa,4,3,7,57.14285714285714,229,252,481,47.60914760914761,-30.559482,22.937506
1971,Spain,4,4,8,50,184,166,350,52.57142857142857,40.463667,-3.74922
1971,United Kingdom,3,2,5,60,127,171,298,42.61744966442953,55.378051,-3.435973
1971,United States,21,27,48,43.75,849,724,1573,53.97329942784488,37.09024,-95.712891
1972,Australia,24,21,45,53.333333333333336,652,637,1289,50.581846392552364,-25.274398,133.775136
1972,Croatia,1,1,2,50,49,46,95,51.578947368421055,45.1,15.2
1972,Czech Republic,2,5,7,28.57142857142857,144,93,237,60.75949367088608,49.817492,15.472962
1972,Germany,1,1,2,50,56,53,109,51.37614678899083,51.165691,10.451526
1972,Netherlands,1,4,5,20,79,41,120,65.83333333333333,52.132633,5.291266
1972,Peru,1,1,2,50,20,19,39,51.28205128205128,-9.189967,-75.015152
1972,Romania,12,5,17,70.58823529411765,151,55,206,73.30097087378641,45.943161,24.96676
1972,South Africa,5,5,10,50,176,160,336,52.38095238095239,-30.559482,22.937506
1972,Spain,9,6,15,60,181,115,296,61.14864864864865,40.463667,-3.74922
1972,United Kingdom,3,2,5,60,154,189,343,44.89795918367347,55.378051,-3.435973
1972,United States,29,26,55,52.72727272727272,933,816,1749,53.34476843910806,37.09024,-95.712891
1973,Australia,22,22,44,50,762,648,1410,54.04255319148936,-25.274398,133.775136
1973,Chile,1,2,3,33.33333333333333,76,91,167,45.50898203592814,-35.675147,-71.542969
1973,Czech Republic,3,3,6,50,130,132,262,49.61832061068702,49.817492,15.472962
1973,Germany,3,5,8,37.5,250,128,378,66.13756613756614,51.165691,10.451526
1973,India,2,1,3,66.66666666666666,71,88,159,44.65408805031446,20.593684,78.96288
1973,Italy,1,6,7,14.285714285714285,125,113,238,52.52100840336135,41.87194,12.56738
1973,Netherlands,7,3,10,70,96,34,130,73.84615384615385,52.132633,5.291266
1973,New Zealand,2,3,5,40,107,101,208,51.442307692307686,-40.900557,174.885971
1973,Romania,15,3,18,83.33333333333334,162,72,234,69.23076923076923,45.943161,24.96676
1973,Spain,5,7,12,41.66666666666667,145,121,266,54.51127819548872,40.463667,-3.74922
1973,United Kingdom,5,5,10,50,218,225,443,49.20993227990971,55.378051,-3.435973
1973,United States,36,31,67,53.73134328358209,1085,958,2043,53.108174253548704,37.09024,-95.712891
1974,Argentina,7,1,8,87.5,120,58,178,67.41573033707866,-38.416097,-63.616672
1974,Australia,20,16,36,55.55555555555556,774,675,1449,53.41614906832298,-25.274398,133.775136
1974,Germany,3,8,11,27.27272727272727,159,168,327,48.62385321100918,51.165691,10.451526
1974,India,1,1,2,50,70,97,167,41.91616766467065,20.593684,78.96288
1974,Italy,1,3,4,25,83,75,158,52.53164556962025,41.87194,12.56738
1974,Mexico,2,1,3,66.66666666666666,95,74,169,56.213017751479285,23.634501,-102.552784
1974,Netherlands,3,3,6,50,77,39,116,66.37931034482759,52.132633,5.291266
1974,New Zealand,2,4,6,33.33333333333333,126,117,243,51.85185185185185,-40.900557,174.885971
1974,Romania,6,5,11,54.54545454545454,103,64,167,61.67664670658682,45.943161,24.96676
1974,Russia,1,3,4,25,60,24,84,71.42857142857143,61.52401,105.318756
1974,South Africa,2,2,4,50,190,157,347,54.7550432276657,-30.559482,22.937506
1974,Sweden,9,5,14,64.28571428571429,143,120,263,54.372623574144484,60.128161,18.643501
1974,United Kingdom,1,4,5,20,323,195,518,62.35521235521235,55.378051,-3.435973
1974,United States,41,31,72,56.94444444444444,1213,1099,2312,52.465397923875436,37.09024,-95.712891
1975,Argentina,5,3,8,62.5,135,81,216,62.5,-38.416097,-63.616672
1975,Australia,14,9,23,60.86956521739131,586,558,1144,51.22377622377622,-25.274398,133.775136
1975,Croatia,1,1,2,50,46,49,95,48.421052631578945,45.1,15.2
1975,Czech Republic,2,5,7,28.57142857142857,130,119,249,52.208835341365464,49.817492,15.472962
1975,Germany,1,4,5,20,175,182,357,49.01960784313725,51.165691,10.451526
1975,Italy,3,4,7,42.857142857142854,106,102,208,50.96153846153846,41.87194,12.56738
1975,Mexico,4,1,5,80,96,78,174,55.172413793103445,23.634501,-102.552784
1975,Netherlands,2,3,5,40,51,51,102,50,52.132633,5.291266
1975,New Zealand,1,3,4,25,101,80,181,55.80110497237569,-40.900557,174.885971
1975,Romania,5,4,9,55.55555555555556,106,50,156,67.94871794871796,45.943161,24.96676
1975,Spain,9,8,17,52.94117647058824,224,168,392,57.14285714285714,40.463667,-3.74922
1975,Sweden,6,4,10,60,132,114,246,53.65853658536586,60.128161,18.643501
1975,United States,37,41,78,47.43589743589743,1170,1083,2253,51.93075898801598,37.09024,-95.712891
1976,Argentina,6,4,10,60,158,103,261,60.53639846743295,-38.416097,-63.616672
1976,Australia,9,10,19,47.368421052631575,489,588,1077,45.40389972144847,-25.274398,133.775136
1976,Chile,1,2,3,33.33333333333333,95,86,181,52.48618784530387,-35.675147,-71.542969
1976,Czech Republic,1,4,5,20,109,105,214,50.93457943925234,49.817492,15.472962
1976,India,2,2,4,50,61,91,152,40.131578947368425,20.593684,78.96288
1976,Italy,6,3,9,66.66666666666666,147,82,229,64.19213973799127,41.87194,12.56738
1976,Mexico,4,5,9,44.44444444444444,106,59,165,64.24242424242425,23.634501,-102.552784
1976,New Zealand,3,2,5,60,102,97,199,51.256281407035175,-40.900557,174.885971
1976,Poland,3,5,8,37.5,81,38,119,68.0672268907563,51.919438,19.145136
1976,Romania,6,6,12,50,84,34,118,71.1864406779661,45.943161,24.96676
1976,South Africa,1,3,4,25,146,186,332,43.97590361445783,-30.559482,22.937506
1976,Spain,8,7,15,53.333333333333336,202,172,374,54.01069518716578,40.463667,-3.74922
1976,Sweden,6,3,9,66.66666666666666,112,116,228,49.122807017543856,60.128161,18.643501
1976,United States,37,35,72,51.388888888888886,1219,1151,2370,51.434599156118146,37.09024,-95.712891
1977,Argentina,16,6,22,72.72727272727273,167,93,260,64.23076923076924,-38.416097,-63.616672
1977,Australia,2,7,9,22.22222222222222,532,609,1141,46.62576687116564,-25.274398,133.775136
1977,Czech Republic,1,2,3,33.33333333333333,106,124,230,46.08695652173913,49.817492,15.472962
1977,France,2,2,4,50,136,166,302,45.033112582781456,46.227638,2.213749
1977,Germany,1,2,3,33.33333333333333,114,138,252,45.23809523809524,51.165691,10.451526
1977,Italy,7,2,9,77.77777777777779,116,79,195,59.48717948717949,41.87194,12.56738
1977,Mexico,2,3,5,40,72,50,122,59.01639344262295,23.634501,-102.552784
1977,Poland,2,5,7,28.57142857142857,72,39,111,64.86486486486487,51.919438,19.145136
1977,Romania,3,2,5,60,69,44,113,61.06194690265486,45.943161,24.96676
1977,Spain,4,5,9,44.44444444444444,149,128,277,53.79061371841155,40.463667,-3.74922
1977,Sweden,12,2,14,85.71428571428571,143,114,257,55.6420233463035,60.128161,18.643501
1977,United Kingdom,1,9,10,10,196,197,393,49.87277353689568,55.378051,-3.435973
1977,United States,43,42,85,50.588235294117645,1462,1341,2803,52.15840171245094,37.09024,-95.712891
1978,Argentina,10,6,16,62.5,136,61,197,69.03553299492386,-38.416097,-63.616672
1978,Australia,2,12,14,14.285714285714285,451,578,1029,43.82896015549077,-25.274398,133.775136
1978,Austria,1,1,2,50,31,43,74,41.891891891891895,47.516231,14.550072
1978,Czech Republic,2,3,5,40,122,144,266,45.86466165413533,49.817492,15.472962
1978,France,2,3,5,40,123,191,314,39.171974522293,46.227638,2.213749
1978,Germany,2,2,4,50,101,109,210,48.095238095238095,51.165691,10.451526
1978,Hungary,2,1,3,66.66666666666666,56,30,86,65.11627906976744,47.162494,19.503304
1978,India,1,1,2,50,51,69,120,42.5,20.593684,78.96288
1978,Italy,2,5,7,28.57142857142857,151,127,278,54.31654676258992,41.87194,12.56738
1978,Mexico,2,6,8,25,82,67,149,55.033557046979865,23.634501,-102.552784
1978,Paraguay,1,2,3,33.33333333333333,38,34,72,52.77777777777778,-23.442503,-58.443832
1978,Poland,1,1,2,50,65,38,103,63.10679611650486,51.919438,19.145136
1978,Romania,2,3,5,40,47,35,82,57.3170731707317,45.943161,24.96676
1978,South Africa,2,1,3,66.66666666666666,110,165,275,40,-30.559482,22.937506
1978,Spain,7,1,8,87.5,152,100,252,60.317460317460316,40.463667,-3.74922
1978,Sweden,10,2,12,83.33333333333334,134,85,219,61.18721461187214,60.128161,18.643501
1978,United States,45,42,87,51.724137931034484,1481,1224,2705,54.750462107208875,37.09024,-95.712891
1979,Argentina,5,6,11,45.45454545454545,135,88,223,60.53811659192825,-38.416097,-63.616672
1979,Australia,6,8,14,42.857142857142854,427,554,981,43.52701325178389,-25.274398,133.775136
1979,Austria,2,2,4,50,41,47,88,46.590909090909086,47.516231,14.550072
1979,Chile,2,1,3,66.66666666666666,77,78,155,49.67741935483871,-35.675147,-71.542969
1979,Czech Republic,1,2,3,33.33333333333333,112,109,221,50.678733031674206,49.817492,15.472962
1979,France,3,2,5,60,175,188,363,48.209366391184574,46.227638,2.213749
1979,Germany,1,3,4,25,113,121,234,48.29059829059829,51.165691,10.451526
1979,Hungary,2,1,3,66.66666666666666,42,25,67,62.68656716417911,47.162494,19.503304
1979,Italy,1,4,5,20,113,109,222,50.9009009009009,41.87194,12.56738
1979,Paraguay,3,4,7,42.857142857142854,77,46,123,62.601626016260155,-23.442503,-58.443832
1979,Poland,2,3,5,40,63,26,89,70.78651685393258,51.919438,19.145136
1979,South Africa,1,2,3,33.33333333333333,87,138,225,38.666666666666664,-30.559482,22.937506
1979,Spain,4,5,9,44.44444444444444,141,138,279,50.53763440860215,40.463667,-3.74922
1979,Sweden,13,2,15,86.66666666666667,125,97,222,56.30630630630631,60.128161,18.643501
1979,United States,47,48,95,49.473684210526315,1654,1358,3012,54.9136786188579,37.09024,-95.712891
1980,Argentina,11,5,16,68.75,155,95,250,62,-38.416097,-63.616672
1980,Australia,4,8,12,33.33333333333333,425,537,962,44.17879417879418,-25.274398,133.775136
1980,Czech Republic,2,1,3,66.66666666666666,92,97,189,48.67724867724868,49.817492,15.472962
1980,France,1,3,4,25,182,245,427,42.62295081967213,46.227638,2.213749
1980,Germany,1,1,2,50,92,133,225,40.88888888888889,51.165691,10.451526
1980,Hungary,3,1,4,75,51,21,72,70.83333333333334,47.162494,19.503304
1980,India,2,3,5,40,87,68,155,56.12903225806451,20.593684,78.96288
1980,Israel,1,2,3,33.33333333333333,39,36,75,52,31.046051,34.851612
1980,Italy,2,8,10,20,121,99,220,55.00000000000001,41.87194,12.56738
1980,Mexico,1,1,2,50,32,31,63,50.79365079365079,23.634501,-102.552784
1980,Paraguay,1,2,3,33.33333333333333,49,40,89,55.0561797752809,-23.442503,-58.443832
1980,Poland,3,1,4,75,59,29,88,67.04545454545455,51.919438,19.145136
1980,Spain,2,1,3,66.66666666666666,110,110,220,50,40.463667,-3.74922
1980,Sweden,10,3,13,76.92307692307693,143,101,244,58.606557377049185,60.128161,18.643501
1980,United States,52,55,107,48.598130841121495,1757,1445,3202,54.871955028107436,37.09024,-95.712891
1981,Argentina,9,8,17,52.94117647058824,195,138,333,58.55855855855856,-38.416097,-63.616672
1981,Australia,7,7,14,50,343,378,721,47.57281553398058,-25.274398,133.775136
1981,Bolivia,1,1,2,50,31,27,58,53.44827586206896,-16.290154,-63.588653
1981,Brazil,1,1,2,50,44,56,100,44,-14.235004,-51.92528
1981,Chile,2,2,4,50,89,98,187,47.593582887700535,-35.675147,-71.542969
1981,Czech Republic,2,2,4,50,102,93,195,52.307692307692314,49.817492,15.472962
1981,Ecuador,1,2,3,33.33333333333333,56,42,98,57.14285714285714,-1.831239,-78.183406
1981,France,3,5,8,37.5,195,232,427,45.66744730679157,46.227638,2.213749
1981,Hungary,2,1,3,66.66666666666666,53,24,77,68.83116883116884,47.162494,19.503304
1981,Italy,1,1,2,50,73,87,160,45.625,41.87194,12.56738
1981,New Zealand,1,4,5,20,66,67,133,49.62406015037594,-40.900557,174.885971
1981,Paraguay,2,2,4,50,60,35,95,63.1578947368421,-23.442503,-58.443832
1981,Poland,1,1,2,50,43,23,66,65.15151515151516,51.919438,19.145136
1981,Spain,1,1,2,50,158,151,309,51.1326860841424,40.463667,-3.74922
1981,Sweden,3,6,9,33.33333333333333,126,140,266,47.368421052631575,60.128161,18.643501
1981,United States,54,41,95,56.84210526315789,1631,1411,3042,53.61604207758054,37.09024,-95.712891
1982,Argentina,12,7,19,63.1578947368421,184,114,298,61.74496644295302,-38.416097,-63.616672
1982,Australia,7,11,18,38.88888888888889,338,371,709,47.672778561354015,-25.274398,133.775136
1982,Chile,3,1,4,75,63,62,125,50.4,-35.675147,-71.542969
1982,Czech Republic,2,3,5,40,100,93,193,51.813471502590666,49.817492,15.472962
1982,Ecuador,2,1,3,66.66666666666666,63,45,108,58.333333333333336,-1.831239,-78.183406
1982,France,5,3,8,62.5,220,231,451,48.78048780487805,46.227638,2.213749
1982,Hungary,2,1,3,66.66666666666666,67,51,118,56.779661016949156,47.162494,19.503304
1982,Mexico,1,2,3,33.33333333333333,32,21,53,60.37735849056604,23.634501,-102.552784
1982,Poland,3,2,5,60,54,28,82,65.85365853658537,51.919438,19.145136
1982,Spain,3,3,6,50,168,183,351,47.863247863247864,40.463667,-3.74922
1982,Sweden,6,5,11,54.54545454545454,178,144,322,55.27950310559007,60.128161,18.643501
1982,United States,56,54,110,50.90909090909091,1710,1496,3206,53.33749220212103,37.09024,-95.712891
1983,Argentina,8,5,13,61.53846153846154,125,86,211,59.241706161137444,-38.416097,-63.616672
1983,Australia,7,6,13,53.84615384615385,259,287,546,47.43589743589743,-25.274398,133.775136
1983,Chile,1,1,2,50,53,69,122,43.44262295081967,-35.675147,-71.542969
1983,Czech Republic,2,4,6,33.33333333333333,91,73,164,55.487804878048784,49.817492,15.472962
1983,Ecuador,1,3,4,25,54,24,78,69.23076923076923,-1.831239,-78.183406
1983,France,3,3,6,50,178,201,379,46.965699208443276,46.227638,2.213749
1983,Peru,1,1,2,50,30,21,51,58.82352941176471,-9.189967,-75.015152
1983,Spain,5,5,10,50,154,142,296,52.02702702702703,40.463667,-3.74922
1983,Sweden,12,7,19,63.1578947368421,271,185,456,59.42982456140351,60.128161,18.643501
1983,Switzerland,1,1,2,50,51,36,87,58.620689655172406,46.818188,8.227512
1983,United States,39,36,75,52,1435,1313,2748,52.219796215429405,37.09024,-95.712891
1984,Australia,2,3,5,40,202,244,446,45.2914798206278,-25.274398,133.775136
1984,Czech Republic,1,5,6,16.666666666666664,92,67,159,57.861635220125784,49.817492,15.472962
1984,Ecuador,5,1,6,83.33333333333334,68,22,90,75.55555555555556,-1.831239,-78.183406
1984,France,1,3,4,25,108,106,214,50.467289719626166,46.227638,2.213749
1984,Italy,2,1,3,66.66666666666666,66,84,150,44,41.87194,12.56738
1984,Spain,4,1,5,80,118,125,243,48.559670781893004,40.463667,-3.74922
1984,Sweden,14,10,24,58.333333333333336,310,191,501,61.876247504990026,60.128161,18.643501
1984,United States,41,37,78,52.56410256410257,1365,1225,2590,52.702702702702695,37.09024,-95.712891
1985,Argentina,2,2,4,50,165,153,318,51.886792452830186,-38.416097,-63.616672
1985,Czech Republic,2,1,3,66.66666666666666,80,89,169,47.337278106508876,49.817492,15.472962
1985,Ecuador,1,1,2,50,36,33,69,52.17391304347826,-1.831239,-78.183406
1985,France,8,3,11,72.72727272727273,184,142,326,56.44171779141104,46.227638,2.213749
1985,Germany,5,5,10,50,171,158,329,51.97568389057751,51.165691,10.451526
1985,Italy,1,1,2,50,59,83,142,41.54929577464789,41.87194,12.56738
1985,New Zealand,1,2,3,33.33333333333333,51,52,103,49.51456310679612,-40.900557,174.885971
1985,Slovakia,2,3,5,40,55,32,87,63.2183908045977,48.669026,19.699024
1985,Sweden,12,15,27,44.44444444444444,358,204,562,63.70106761565836,60.128161,18.643501
1985,United States,37,30,67,55.223880597014926,1256,1123,2379,52.79529213955444,37.09024,-95.712891
1985,Uruguay,1,1,2,50,32,23,55,58.18181818181818,-32.522779,-55.765835
1986,Argentina,2,4,6,33.33333333333333,160,151,311,51.446945337620576,-38.416097,-63.616672
1986,Australia,1,4,5,20,133,163,296,44.932432432432435,-25.274398,133.775136
1986,Czech Republic,1,2,3,33.33333333333333,91,90,181,50.27624309392266,49.817492,15.472962
1986,Ecuador,4,2,6,66.66666666666666,59,30,89,66.29213483146067,-1.831239,-78.183406
1986,France,7,9,16,43.75,191,112,303,63.03630363036304,46.227638,2.213749
1986,Germany,6,5,11,54.54545454545454,181,180,361,50.13850415512465,51.165691,10.451526
1986,Italy,2,1,3,66.66666666666666,69,91,160,43.125,41.87194,12.56738
1986,Slovakia,1,2,3,33.33333333333333,63,42,105,60,48.669026,19.699024
1986,Spain,3,2,5,60,146,153,299,48.82943143812709,40.463667,-3.74922
1986,Sweden,17,19,36,47.22222222222222,450,275,725,62.06896551724138,60.128161,18.643501
1986,United States,20,16,36,55.55555555555556,929,932,1861,49.91939817302525,37.09024,-95.712891
1987,Argentina,5,2,7,71.42857142857143,199,172,371,53.63881401617251,-38.416097,-63.616672
1987,Australia,4,5,9,44.44444444444444,221,252,473,46.723044397463006,-25.274398,133.775136
1987,Brazil,1,3,4,25,51,74,125,40.8,-14.235004,-51.92528
1987,Ecuador,1,1,2,50,53,24,77,68.83116883116884,-1.831239,-78.183406
1987,France,2,1,3,66.66666666666666,147,152,299,49.163879598662206,46.227638,2.213749
1987,Germany,3,5,8,37.5,195,209,404,48.26732673267327,51.165691,10.451526
1987,Israel,1,1,2,50,51,49,100,51,31.046051,34.851612
1987,Italy,1,3,4,25,78,115,193,40.41450777202073,41.87194,12.56738
1987,Slovakia,8,4,12,66.66666666666666,99,39,138,71.73913043478261,48.669026,19.699024
1987,Spain,4,3,7,57.14285714285714,146,151,297,49.158249158249156,40.463667,-3.74922
1987,Sweden,18,14,32,56.25,443,282,725,61.10344827586207,60.128161,18.643501
1987,United States,21,30,51,41.17647058823529,1011,1035,2046,49.41348973607038,37.09024,-95.712891
1988,Argentina,2,7,9,22.22222222222222,221,211,432,51.157407407407405,-38.416097,-63.616672
1988,Australia,4,5,9,44.44444444444444,266,268,534,49.812734082397,-25.274398,133.775136
1988,Austria,6,2,8,75,84,54,138,60.86956521739131,47.516231,14.550072
1988,France,3,4,7,42.857142857142854,173,164,337,51.33531157270029,46.227638,2.213749
1988,Germany,8,1,9,88.88888888888889,233,246,479,48.643006263048015,51.165691,10.451526
1988,India,1,3,4,25,37,23,60,61.66666666666667,20.593684,78.96288
1988,Italy,1,2,3,33.33333333333333,86,133,219,39.26940639269406,41.87194,12.56738
1988,Russia,1,3,4,25,66,37,103,64.07766990291263,61.52401,105.318756
1988,Slovakia,2,2,4,50,59,51,110,53.63636363636364,48.669026,19.699024
1988,Spain,2,4,6,33.33333333333333,168,161,329,51.06382978723404,40.463667,-3.74922
1988,Sweden,19,10,29,65.51724137931035,412,292,704,58.52272727272727,60.128161,18.643501
1988,Switzerland,2,3,5,40,67,42,109,61.46788990825688,46.818188,8.227512
1988,United States,21,25,46,45.65217391304348,996,908,1904,52.3109243697479,37.09024,-95.712891
1988,Uruguay,1,1,2,50,45,36,81,55.55555555555556,-32.522779,-55.765835
1989,Argentina,10,6,16,62.5,227,178,405,56.04938271604938,-38.416097,-63.616672
1989,Australia,2,3,5,40,195,236,431,45.243619489559165,-25.274398,133.775136
1989,Czech Republic,1,2,3,33.33333333333333,81,109,190,42.63157894736842,49.817492,15.472962
1989,France,1,3,4,25,109,144,253,43.08300395256917,46.227638,2.213749
1989,Germany,8,5,13,61.53846153846154,232,201,433,53.5796766743649,51.165691,10.451526
1989,Italy,1,1,2,50,117,149,266,43.984962406015036,41.87194,12.56738
1989,New Zealand,1,1,2,50,39,33,72,54.166666666666664,-40.900557,174.885971
1989,Russia,2,2,4,50,68,65,133,51.127819548872175,61.52401,105.318756
1989,Slovakia,1,2,3,33.33333333333333,34,35,69,49.275362318840585,48.669026,19.699024
1989,South Africa,1,1,2,50,75,87,162,46.2962962962963,-30.559482,22.937506
1989,Spain,4,5,9,44.44444444444444,194,179,373,52.01072386058981,40.463667,-3.74922
1989,Sweden,3,14,17,17.647058823529413,310,276,586,52.901023890784984,60.128161,18.643501
1989,Switzerland,2,1,3,66.66666666666666,50,41,91,54.94505494505495,46.818188,8.227512
1989,United States,35,18,53,66.0377358490566,1018,855,1873,54.35130806193273,37.09024,-95.712891
1990,Argentina,5,5,10,50,165,149,314,52.547770700636946,-38.416097,-63.616672
1990,Australia,3,5,8,37.5,202,229,431,46.8677494199536,-25.274398,133.775136
1990,Austria,5,4,9,55.55555555555556,111,71,182,60.98901098901099,47.516231,14.550072
1990,Brazil,1,1,2,50,50,60,110,45.45454545454545,-14.235004,-51.92528
1990,Croatia,4,4,8,50,90,68,158,56.9620253164557,45.1,15.2
1990,Czech Republic,1,1,2,50,89,125,214,41.58878504672897,49.817492,15.472962
1990,Ecuador,3,1,4,75,41,32,73,56.16438356164384,-1.831239,-78.183406
1990,France,2,3,5,40,191,223,414,46.13526570048309,46.227638,2.213749
1990,Germany,6,7,13,46.15384615384615,236,229,465,50.752688172043015,51.165691,10.451526
1990,Israel,1,2,3,33.33333333333333,71,59,130,54.61538461538461,31.046051,34.851612
1990,Russia,3,4,7,42.857142857142854,120,86,206,58.252427184466015,61.52401,105.318756
1990,South Africa,1,2,3,33.33333333333333,66,72,138,47.82608695652174,-30.559482,22.937506
1990,Spain,7,4,11,63.63636363636363,240,228,468,51.28205128205128,40.463667,-3.74922
1990,Sweden,11,10,21,52.38095238095239,321,285,606,52.97029702970298,60.128161,18.643501
1990,Switzerland,2,2,4,50,80,52,132,60.60606060606061,46.818188,8.227512
1990,United States,25,21,46,54.347826086956516,931,809,1740,53.50574712643679,37.09024,-95.712891
1991,Argentina,4,5,9,44.44444444444444,169,154,323,52.32198142414861,-38.416097,-63.616672
1991,Australia,2,1,3,66.66666666666666,163,199,362,45.027624309392266,-25.274398,133.775136
1991,Austria,2,2,4,50,79,73,152,51.973684210526315,47.516231,14.550072
1991,Croatia,1,4,5,20,83,58,141,58.86524822695035,45.1,15.2
1991,Czech Republic,6,4,10,60,116,96,212,54.71698113207547,49.817492,15.472962
1991,France,7,7,14,50,263,249,512,51.3671875,46.227638,2.213749
1991,Germany,10,7,17,58.82352941176471,277,255,532,52.06766917293233,51.165691,10.451526
1991,Italy,3,1,4,75,137,156,293,46.75767918088737,41.87194,12.56738
1991,Netherlands,2,2,4,50,127,130,257,49.416342412451364,52.132633,5.291266
1991,Russia,3,1,4,75,121,95,216,56.018518518518526,61.52401,105.318756
1991,Spain,8,9,17,47.05882352941176,265,230,495,53.535353535353536,40.463667,-3.74922
1991,Sweden,13,9,22,59.09090909090909,351,302,653,53.751914241960186,60.128161,18.643501
1991,Switzerland,1,1,2,50,76,66,142,53.52112676056338,46.818188,8.227512
1991,United States,17,23,40,42.5,785,680,1465,53.58361774744027,37.09024,-95.712891
1992,Argentina,2,6,8,25,151,197,348,43.39080459770115,-38.416097,-63.616672
1992,Australia,1,5,6,16.666666666666664,190,217,407,46.68304668304668,-25.274398,133.775136
1992,Austria,3,1,4,75,83,75,158,52.53164556962025,47.516231,14.550072
1992,Brazil,3,1,4,75,72,80,152,47.368421052631575,-14.235004,-51.92528
1992,Croatia,4,2,6,66.66666666666666,79,41,120,65.83333333333333,45.1,15.2
1992,Czech Republic,6,6,12,50,133,107,240,55.41666666666667,49.817492,15.472962
1992,France,2,6,8,25,256,274,530,48.301886792452834,46.227638,2.213749
1992,Germany,9,2,11,81.81818181818183,273,291,564,48.40425531914894,51.165691,10.451526
1992,Italy,2,3,5,40,150,195,345,43.47826086956522,41.87194,12.56738
1992,Japan,1,1,2,50,25,26,51,49.01960784313725,36.204824,138.252924
1992,Netherlands,3,2,5,60,158,165,323,48.91640866873065,52.132633,5.291266
1992,South Africa,2,3,5,40,92,92,184,50,-30.559482,22.937506
1992,Spain,10,14,24,41.66666666666667,336,303,639,52.58215962441315,40.463667,-3.74922
1992,Sweden,7,8,15,46.666666666666664,285,281,566,50.35335689045937,60.128161,18.643501
1992,Switzerland,2,1,3,66.66666666666666,87,71,158,55.06329113924051,46.818188,8.227512
1992,United States,24,18,42,57.14285714285714,768,599,1367,56.181419166057054,37.09024,-95.712891
1993,Argentina,3,1,4,75,109,146,255,42.745098039215684,-38.416097,-63.616672
1993,Australia,2,4,6,33.33333333333333,217,226,443,48.98419864559819,-25.274398,133.775136
1993,Austria,8,2,10,80,126,89,215,58.6046511627907,47.516231,14.550072
1993,Croatia,3,3,6,50,67,41,108,62.03703703703704,45.1,15.2
1993,Czech Republic,3,6,9,33.33333333333333,157,143,300,52.33333333333333,49.817492,15.472962
1993,France,3,7,10,30,240,261,501,47.90419161676647,46.227638,2.213749
1993,Germany,9,8,17,52.94117647058824,290,289,579,50.086355785837654,51.165691,10.451526
1993,Israel,1,2,3,33.33333333333333,52,35,87,59.77011494252874,31.046051,34.851612
1993,Italy,1,2,3,33.33333333333333,113,148,261,43.29501915708812,41.87194,12.56738
1993,Netherlands,2,2,4,50,125,133,258,48.44961240310077,52.132633,5.291266
1993,Peru,2,1,3,66.66666666666666,40,24,64,62.5,-9.189967,-75.015152
1993,Russia,2,4,6,33.33333333333333,160,136,296,54.054054054054056,61.52401,105.318756
1993,Spain,10,11,21,47.61904761904761,346,332,678,51.03244837758112,40.463667,-3.74922
1993,Sweden,6,10,16,37.5,340,318,658,51.671732522796354,60.128161,18.643501
1993,Ukraine,3,2,5,60,64,29,93,68.81720430107528,48.379433,31.16558
1993,United Kingdom,1,1,2,50,43,50,93,46.236559139784944,55.378051,-3.435973
1993,United States,29,19,48,60.416666666666664,767,650,1417,54.12844036697248,37.09024,-95.712891
1994,Argentina,1,2,3,33.33333333333333,75,101,176,42.61363636363637,-38.416097,-63.616672
1994,Australia,2,8,10,20,213,246,459,46.40522875816993,-25.274398,133.775136
1994,Austria,3,1,4,75,110,103,213,51.64319248826291,47.516231,14.550072
1994,Brazil,1,2,3,33.33333333333333,44,52,96,45.83333333333333,-14.235004,-51.92528
1994,Croatia,2,4,6,33.33333333333333,67,30,97,69.0721649484536,45.1,15.2
1994,Czech Republic,1,5,6,16.666666666666664,176,176,352,50,49.817492,15.472962
1994,Germany,10,11,21,47.61904761904761,313,301,614,50.9771986970684,51.165691,10.451526
1994,Italy,2,1,3,66.66666666666666,129,167,296,43.58108108108108,41.87194,12.56738
1994,Netherlands,5,2,7,71.42857142857143,124,96,220,56.36363636363636,52.132633,5.291266
1994,Russia,4,3,7,57.14285714285714,176,150,326,53.987730061349694,61.52401,105.318756
1994,South Africa,5,2,7,71.42857142857143,122,106,228,53.50877192982456,-30.559482,22.937506
1994,Spain,15,12,27,55.55555555555556,412,339,751,54.860186418109194,40.463667,-3.74922
1994,Sweden,8,4,12,66.66666666666666,334,312,646,51.702786377708975,60.128161,18.643501
1994,Switzerland,2,2,4,50,74,54,128,57.8125,46.818188,8.227512
1994,Ukraine,2,2,4,50,46,33,79,58.22784810126582,48.379433,31.16558
1994,United States,26,20,46,56.52173913043478,742,608,1350,54.962962962962955,37.09024,-95.712891
1995,Argentina,1,2,3,33.33333333333333,63,63,126,50,-38.416097,-63.616672
1995,Australia,1,5,6,16.666666666666664,225,238,463,48.59611231101512,-25.274398,133.775136
1995,Austria,13,4,17,76.47058823529412,133,75,208,63.942307692307686,47.516231,14.550072
1995,Brazil,1,1,2,50,31,33,64,48.4375,-14.235004,-51.92528
1995,Chile,3,1,4,75,46,27,73,63.013698630136986,-35.675147,-71.542969
1995,Colombia,1,1,2,50,23,21,44,52.27272727272727,4.570868,-74.297333
1995,Croatia,2,2,4,50,49,35,84,58.333333333333336,45.1,15.2
1995,Czech Republic,3,4,7,42.857142857142854,170,197,367,46.321525885558586,49.817492,15.472962
1995,France,1,5,6,16.666666666666664,201,282,483,41.61490683229814,46.227638,2.213749
1995,Germany,7,9,16,43.75,286,301,587,48.722316865417376,51.165691,10.451526
1995,Netherlands,4,6,10,40,168,148,316,53.16455696202531,52.132633,5.291266
1995,Russia,4,2,6,66.66666666666666,142,112,254,55.90551181102362,61.52401,105.318756
1995,Spain,4,10,14,28.57142857142857,358,365,723,49.51590594744122,40.463667,-3.74922
1995,Sweden,7,8,15,46.666666666666664,277,208,485,57.113402061855666,60.128161,18.643501
1995,Switzerland,2,2,4,50,74,56,130,56.92307692307692,46.818188,8.227512
1995,United Kingdom,1,1,2,50,72,99,171,42.10526315789473,55.378051,-3.435973
1995,United States,22,19,41,53.65853658536586,630,533,1163,54.170249355116084,37.09024,-95.712891
1996,Argentina,1,1,2,50,87,103,190,45.78947368421053,-38.416097,-63.616672
1996,Australia,2,2,4,50,244,228,472,51.69491525423729,-25.274398,133.775136
1996,Austria,7,1,8,87.5,89,62,151,58.94039735099338,47.516231,14.550072
1996,Chile,1,3,4,25,62,31,93,66.66666666666666,-35.675147,-71.542969
1996,Croatia,5,5,10,50,84,34,118,71.1864406779661,45.1,15.2
1996,Czech Republic,4,7,11,36.36363636363637,203,185,388,52.31958762886598,49.817492,15.472962
1996,France,2,4,6,33.33333333333333,175,214,389,44.987146529562985,46.227638,2.213749
1996,Germany,8,4,12,66.66666666666666,217,237,454,47.797356828193834,51.165691,10.451526
1996,Morocco,2,3,5,40,46,65,111,41.44144144144144,31.791702,-7.09262
1996,Netherlands,3,5,8,37.5,160,155,315,50.79365079365079,52.132633,5.291266
1996,Russia,5,6,11,45.45454545454545,129,105,234,55.12820512820513,61.52401,105.318756
1996,South Africa,2,3,5,40,92,88,180,51.11111111111111,-30.559482,22.937506
1996,Spain,12,13,25,48,448,403,851,52.64394829612221,40.463667,-3.74922
1996,Sweden,6,4,10,60,297,246,543,54.69613259668509,60.128161,18.643501
1996,Switzerland,1,2,3,33.33333333333333,66,67,133,49.62406015037594,46.818188,8.227512
1996,Ukraine,1,1,2,50,35,29,64,54.6875,48.379433,31.16558
1996,United States,20,13,33,60.60606060606061,509,396,905,56.24309392265193,37.09024,-95.712891
1996,Zimbabwe,1,2,3,33.33333333333333,42,37,79,53.16455696202531,-19.015438,29.154857
1997,Australia,7,13,20,35,276,218,494,55.87044534412956,-25.274398,133.775136
1997,Austria,2,1,3,66.66666666666666,66,55,121,54.54545454545454,47.516231,14.550072
1997,Brazil,1,2,3,33.33333333333333,64,57,121,52.892561983471076,-14.235004,-51.92528
1997,Chile,1,4,5,20,64,35,99,64.64646464646465,-35.675147,-71.542969
1997,Croatia,3,2,5,60,58,36,94,61.702127659574465,45.1,15.2
1997,Czech Republic,2,7,9,22.22222222222222,177,168,345,51.30434782608696,49.817492,15.472962
1997,France,2,3,5,40,194,238,432,44.907407407407405,46.227638,2.213749
1997,Germany,1,3,4,25,217,247,464,46.76724137931034,51.165691,10.451526
1997,Netherlands,4,2,6,66.66666666666666,131,147,278,47.122302158273385,52.132633,5.291266
1997,Russia,3,2,5,60,78,79,157,49.681528662420384,61.52401,105.318756
1997,Slovakia,2,3,5,40,82,64,146,56.16438356164384,48.669026,19.699024
1997,Spain,17,18,35,48.57142857142857,534,433,967,55.222337125129265,40.463667,-3.74922
1997,Sweden,9,6,15,60,296,235,531,55.74387947269304,60.128161,18.643501
1997,Switzerland,1,1,2,50,36,40,76,47.368421052631575,46.818188,8.227512
1997,United Kingdom,4,6,10,40,120,74,194,61.855670103092784,55.378051,-3.435973
1997,United States,17,1,18,94.44444444444444,407,381,788,51.649746192893396,37.09024,-95.712891
1998,Argentina,2,2,4,50,89,98,187,47.593582887700535,-38.416097,-63.616672
1998,Australia,10,8,18,55.55555555555556,276,238,514,53.69649805447471,-25.274398,133.775136
1998,Chile,7,1,8,87.5,71,23,94,75.53191489361703,-35.675147,-71.542969
1998,Croatia,1,4,5,20,48,34,82,58.536585365853654,45.1,15.2
1998,Czech Republic,4,4,8,50,166,169,335,49.55223880597015,49.817492,15.472962
1998,Germany,2,3,5,40,203,264,467,43.46895074946467,51.165691,10.451526
1998,Italy,1,3,4,25,133,150,283,46.996466431095406,41.87194,12.56738
1998,Netherlands,4,2,6,66.66666666666666,160,138,298,53.691275167785236,52.132633,5.291266
1998,Russia,3,3,6,50,81,60,141,57.446808510638306,61.52401,105.318756
1998,Slovakia,3,3,6,50,96,70,166,57.831325301204814,48.669026,19.699024
1998,Spain,14,10,24,58.333333333333336,450,458,908,49.55947136563877,40.463667,-3.74922
1998,Sweden,6,6,12,50,239,197,436,54.81651376146789,60.128161,18.643501
1998,United Kingdom,4,5,9,44.44444444444444,116,77,193,60.10362694300518,55.378051,-3.435973
1998,United States,14,11,25,56.00000000000001,422,352,774,54.52196382428941,37.09024,-95.712891
1999,Argentina,1,4,5,20,116,182,298,38.92617449664429,-38.416097,-63.616672
1999,Australia,5,6,11,45.45454545454545,232,198,430,53.95348837209303,-25.274398,133.775136
1999,Austria,1,1,2,50,62,60,122,50.81967213114754,47.516231,14.550072
1999,Chile,3,2,5,60,54,21,75,72,-35.675147,-71.542969
1999,Ecuador,2,1,3,66.66666666666666,59,29,88,67.04545454545455,-1.831239,-78.183406
1999,France,5,4,9,55.55555555555556,234,232,466,50.21459227467812,46.227638,2.213749
1999,Germany,5,8,13,38.46153846153847,234,221,455,51.42857142857142,51.165691,10.451526
1999,Morocco,1,3,4,25,91,75,166,54.81927710843374,31.791702,-7.09262
1999,Netherlands,3,1,4,75,131,140,271,48.33948339483395,52.132633,5.291266
1999,Romania,1,2,3,33.33333333333333,50,62,112,44.642857142857146,45.943161,24.96676
1999,Russia,4,3,7,57.14285714285714,109,86,195,55.8974358974359,61.52401,105.318756
1999,Spain,9,8,17,52.94117647058824,331,306,637,51.96232339089482,40.463667,-3.74922
1999,Sweden,11,6,17,64.70588235294117,213,183,396,53.78787878787878,60.128161,18.643501
1999,Switzerland,1,1,2,50,54,61,115,46.95652173913044,46.818188,8.227512
1999,United Kingdom,2,6,8,25,100,73,173,57.80346820809249,55.378051,-3.435973
1999,United States,13,8,21,61.904761904761905,363,306,669,54.26008968609865,37.09024,-95.712891
1999,Zimbabwe,1,2,3,33.33333333333333,44,45,89,49.43820224719101,-19.015438,29.154857
2000,Argentina,4,5,9,44.44444444444444,181,196,377,48.01061007957559,-38.416097,-63.616672
2000,Australia,7,8,15,46.666666666666664,225,176,401,56.10972568578554,-25.274398,133.775136
2000,Brazil,5,2,7,71.42857142857143,93,67,160,58.12500000000001,-14.235004,-51.92528
2000,Chile,2,1,3,66.66666666666666,69,54,123,56.09756097560976,-35.675147,-71.542969
2000,France,6,2,8,75,262,268,530,49.43396226415094,46.227638,2.213749
2000,Germany,3,8,11,27.27272727272727,176,190,366,48.08743169398907,51.165691,10.451526
2000,Netherlands,2,3,5,40,93,88,181,51.38121546961326,52.132633,5.291266
2000,Russia,9,7,16,56.25,152,87,239,63.59832635983263,61.52401,105.318756
2000,Slovakia,2,3,5,40,75,65,140,53.57142857142857,48.669026,19.699024
2000,Spain,9,7,16,56.25,364,342,706,51.55807365439094,40.463667,-3.74922
2000,Sweden,11,8,19,57.89473684210527,259,186,445,58.20224719101124,60.128161,18.643501
2000,Switzerland,2,2,4,50,97,103,200,48.5,46.818188,8.227512
2000,United Kingdom,2,3,5,40,90,78,168,53.57142857142857,55.378051,-3.435973
2000,United States,4,6,10,40,275,309,584,47.08904109589041,37.09024,-95.712891
2001,Argentina,2,8,10,20,199,180,379,52.5065963060686,-38.416097,-63.616672
2001,Australia,9,4,13,69.23076923076923,196,130,326,60.122699386503065,-25.274398,133.775136
2001,Brazil,6,3,9,66.66666666666666,101,69,170,59.411764705882355,-14.235004,-51.92528
2001,Chile,2,1,3,66.66666666666666,60,59,119,50.42016806722689,-35.675147,-71.542969
2001,Czech Republic,4,2,6,66.66666666666666,117,146,263,44.48669201520912,49.817492,15.472962
2001,France,2,7,9,22.22222222222222,261,262,523,49.90439770554494,46.227638,2.213749
2001,Germany,5,3,8,62.5,170,209,379,44.854881266490764,51.165691,10.451526
2001,Italy,2,1,3,66.66666666666666,50,93,143,34.96503496503497,41.87194,12.56738
2001,Morocco,1,3,4,25,70,70,140,50,31.791702,-7.09262
2001,Netherlands,1,1,2,50,82,93,175,46.85714285714286,52.132633,5.291266
2001,Russia,5,5,10,50,165,124,289,57.09342560553633,61.52401,105.318756
2001,Spain,12,11,23,52.17391304347826,453,411,864,52.43055555555556,40.463667,-3.74922
2001,Sweden,2,3,5,40,188,160,348,54.02298850574713,60.128161,18.643501
2001,Switzerland,1,4,5,20,105,98,203,51.724137931034484,46.818188,8.227512
2001,United Kingdom,3,2,5,60,108,74,182,59.34065934065934,55.378051,-3.435973
2001,United States,8,6,14,57.14285714285714,264,257,521,50.67178502879079,37.09024,-95.712891
2002,Argentina,10,11,21,47.61904761904761,282,223,505,55.84158415841585,-38.416097,-63.616672
2002,Australia,5,4,9,55.55555555555556,107,82,189,56.613756613756614,-25.274398,133.775136
2002,Brazil,1,2,3,33.33333333333333,81,97,178,45.50561797752809,-14.235004,-51.92528
2002,Chile,3,2,5,60,101,65,166,60.8433734939759,-35.675147,-71.542969
2002,Ecuador,1,1,2,50,38,30,68,55.88235294117647,-1.831239,-78.183406
2002,France,5,3,8,62.5,251,262,513,48.927875243664715,46.227638,2.213749
2002,Germany,1,3,4,25,149,162,311,47.90996784565916,51.165691,10.451526
2002,Morocco,3,2,5,60,62,53,115,53.91304347826087,31.791702,-7.09262
2002,Netherlands,1,1,2,50,70,72,142,49.29577464788733,52.132633,5.291266
2002,Russia,4,5,9,44.44444444444444,151,129,280,53.92857142857142,61.52401,105.318756
2002,Spain,10,12,22,45.45454545454545,401,370,771,52.01037613488976,40.463667,-3.74922
2002,Sweden,3,1,4,75,104,114,218,47.706422018348626,60.128161,18.643501
2002,Switzerland,3,2,5,60,98,90,188,52.12765957446809,46.818188,8.227512
2002,Thailand,2,2,4,50,54,28,82,65.85365853658537,15.870032,100.992541
2002,United Kingdom,3,3,6,50,90,68,158,56.9620253164557,55.378051,-3.435973
2002,United States,10,8,18,55.55555555555556,320,276,596,53.691275167785236,37.09024,-95.712891
2003,Argentina,7,7,14,50,298,222,520,57.30769230769231,-38.416097,-63.616672
2003,Australia,3,3,6,50,114,105,219,52.054794520547944,-25.274398,133.775136
2003,Austria,1,1,2,50,48,67,115,41.73913043478261,47.516231,14.550072
2003,Brazil,2,1,3,66.66666666666666,83,82,165,50.303030303030305,-14.235004,-51.92528
2003,Chile,3,7,10,30,89,65,154,57.7922077922078,-35.675147,-71.542969
2003,Czech Republic,2,3,5,40,96,102,198,48.484848484848484,49.817492,15.472962
2003,France,2,5,7,28.57142857142857,211,233,444,47.52252252252252,46.227638,2.213749
2003,Germany,2,3,5,40,139,145,284,48.943661971830984,51.165691,10.451526
2003,Netherlands,3,3,6,50,114,109,223,51.12107623318386,52.132633,5.291266
2003,Russia,2,3,5,40,115,132,247,46.558704453441294,61.52401,105.318756
2003,Slovakia,1,2,3,33.33333333333333,62,73,135,45.925925925925924,48.669026,19.699024
2003,Spain,10,7,17,58.82352941176471,410,379,789,51.964512040557665,40.463667,-3.74922
2003,Switzerland,7,2,9,77.77777777777779,103,74,177,58.19209039548022,46.818188,8.227512
2003,Thailand,2,1,3,66.66666666666666,55,32,87,63.2183908045977,15.870032,100.992541
2003,United States,16,8,24,66.66666666666666,375,297,672,55.80357142857143,37.09024,-95.712891
2004,Argentina,9,14,23,39.130434782608695,281,197,478,58.78661087866108,-38.416097,-63.616672
2004,Australia,4,5,9,44.44444444444444,113,86,199,56.78391959798995,-25.274398,133.775136
2004,Brazil,2,1,3,66.66666666666666,53,51,104,50.96153846153846,-14.235004,-51.92528
2004,Chile,5,1,6,83.33333333333334,95,62,157,60.509554140127385,-35.675147,-71.542969
2004,Czech Republic,3,1,4,75,125,130,255,49.01960784313725,49.817492,15.472962
2004,France,4,3,7,57.14285714285714,261,285,546,47.8021978021978,46.227638,2.213749
2004,Germany,2,7,9,22.22222222222222,167,173,340,49.11764705882353,51.165691,10.451526
2004,Italy,1,2,3,33.33333333333333,65,81,146,44.52054794520548,41.87194,12.56738
2004,Netherlands,1,1,2,50,77,98,175,44,52.132633,5.291266
2004,Russia,6,5,11,54.54545454545454,181,149,330,54.848484848484844,61.52401,105.318756
2004,Slovakia,3,2,5,60,76,66,142,53.52112676056338,48.669026,19.699024
2004,Spain,8,7,15,53.333333333333336,412,408,820,50.24390243902439,40.463667,-3.74922
2004,Sweden,3,2,5,60,133,124,257,51.75097276264592,60.128161,18.643501
2004,Thailand,1,1,2,50,49,37,86,56.97674418604651,15.870032,100.992541
2004,United Kingdom,1,2,3,33.33333333333333,79,58,137,57.66423357664233,55.378051,-3.435973
2004,United States,6,10,16,37.5,320,277,597,53.60134003350083,37.09024,-95.712891
2005,Argentina,10,9,19,52.63157894736842,335,229,564,59.39716312056738,-38.416097,-63.616672
2005,Australia,2,2,4,50,77,69,146,52.73972602739726,-25.274398,133.775136
2005,Belgium,1,1,2,50,88,97,185,47.56756756756757,50.503887,4.469936
2005,Chile,3,1,4,75,73,54,127,57.48031496062992,-35.675147,-71.542969
2005,Croatia,3,9,12,25,119,86,205,58.048780487804876,45.1,15.2
2005,Czech Republic,1,5,6,16.666666666666664,175,209,384,45.57291666666667,49.817492,15.472962
2005,France,3,6,9,33.33333333333333,221,273,494,44.73684210526316,46.227638,2.213749
2005,Germany,1,4,5,20,160,217,377,42.44031830238727,51.165691,10.451526
2005,Russia,5,2,7,71.42857142857143,166,123,289,57.43944636678201,61.52401,105.318756
2005,Spain,12,10,22,54.54545454545454,449,396,845,53.13609467455621,40.463667,-3.74922
2005,Switzerland,11,2,13,84.61538461538461,107,39,146,73.28767123287672,46.818188,8.227512
2005,United Kingdom,1,1,2,50,69,73,142,48.59154929577465,55.378051,-3.435973
2005,United States,9,8,17,52.94117647058824,299,264,563,53.108348134991125,37.09024,-95.712891
2006,Argentina,3,4,7,42.857142857142854,238,214,452,52.654867256637175,-38.416097,-63.616672
2006,Australia,2,2,4,50,63,58,121,52.066115702479344,-25.274398,133.775136
2006,Austria,1,3,4,25,68,62,130,52.307692307692314,47.516231,14.550072
2006,Belgium,1,4,5,20,115,105,220,52.27272727272727,50.503887,4.469936
2006,Chile,1,6,7,14.285714285714285,98,66,164,59.756097560975604,-35.675147,-71.542969
2006,Croatia,7,5,12,58.333333333333336,139,77,216,64.35185185185185,45.1,15.2
2006,Cyprus,1,1,2,50,37,24,61,60.65573770491803,35.126413,33.429859
2006,Czech Republic,1,4,5,20,151,186,337,44.80712166172107,49.817492,15.472962
2006,Finland,1,1,2,50,56,32,88,63.63636363636363,61.92411,25.748151
2006,France,6,4,10,60,271,293,564,48.04964539007092,46.227638,2.213749
2006,Germany,3,3,6,50,199,224,423,47.04491725768322,51.165691,10.451526
2006,Italy,2,2,4,50,116,171,287,40.41811846689895,41.87194,12.56738
2006,Russia,6,5,11,54.54545454545454,211,153,364,57.96703296703297,61.52401,105.318756
2006,Serbia,2,1,3,66.66666666666666,67,68,135,49.629629629629626,44.016521,21.005859
2006,Spain,10,6,16,62.5,383,332,715,53.56643356643357,40.463667,-3.74922
2006,Switzerland,13,4,17,76.47058823529412,135,47,182,74.17582417582418,46.818188,8.227512
2006,United Kingdom,1,2,3,33.33333333333333,91,83,174,52.29885057471264,55.378051,-3.435973
2006,United States,7,6,13,53.84615384615385,250,257,507,49.30966469428008,37.09024,-95.712891
2007,Argentina,8,5,13,61.53846153846154,295,276,571,51.66374781085814,-38.416097,-63.616672
2007,Australia,1,1,2,50,57,57,114,50,-25.274398,133.775136
2007,Belgium,3,1,4,75,57,70,127,44.881889763779526,50.503887,4.469936
2007,Chile,1,3,4,25,67,66,133,50.37593984962406,-35.675147,-71.542969
2007,Croatia,5,3,8,62.5,118,77,195,60.51282051282051,45.1,15.2
2007,Cyprus,1,2,3,33.33333333333333,49,25,74,66.21621621621621,35.126413,33.429859
2007,Czech Republic,3,1,4,75,108,118,226,47.78761061946903,49.817492,15.472962
2007,France,7,8,15,46.666666666666664,362,340,702,51.566951566951566,46.227638,2.213749
2007,Germany,2,1,3,66.66666666666666,172,196,368,46.73913043478261,51.165691,10.451526
2007,Russia,4,2,6,66.66666666666666,218,185,403,54.09429280397022,61.52401,105.318756
2007,Serbia,5,2,7,71.42857142857143,105,69,174,60.3448275862069,44.016521,21.005859
2007,Spain,13,12,25,52,435,324,759,57.31225296442688,40.463667,-3.74922
2007,Switzerland,8,6,14,57.14285714285714,95,46,141,67.37588652482269,46.818188,8.227512
2007,United Kingdom,2,2,4,50,53,48,101,52.475247524752476,55.378051,-3.435973
2007,United States,4,6,10,40,246,267,513,47.953216374269005,37.09024,-95.712891
2008,Argentina,6,7,13,46.15384615384615,251,239,490,51.22448979591837,-38.416097,-63.616672
2008,Belgium,1,1,2,50,56,85,141,39.71631205673759,50.503887,4.469936
2008,Chile,2,1,3,66.66666666666666,55,46,101,54.45544554455446,-35.675147,-71.542969
2008,Croatia,2,2,4,50,130,105,235,55.319148936170215,45.1,15.2
2008,Czech Republic,1,2,3,33.33333333333333,97,112,209,46.411483253588514,49.817492,15.472962
2008,France,8,8,16,50,345,342,687,50.21834061135371,46.227638,2.213749
2008,Germany,2,2,4,50,173,212,385,44.935064935064936,51.165691,10.451526
2008,Russia,8,7,15,53.333333333333336,222,165,387,57.36434108527132,61.52401,105.318756
2008,Serbia,4,4,8,50,117,77,194,60.30927835051546,44.016521,21.005859
2008,Spain,16,10,26,61.53846153846154,435,321,756,57.53968253968254,40.463667,-3.74922
2008,Sweden,2,4,6,33.33333333333333,74,65,139,53.23741007194245,60.128161,18.643501
2008,Switzerland,4,6,10,40,114,51,165,69.0909090909091,46.818188,8.227512
2008,United Kingdom,5,1,6,83.33333333333334,61,35,96,63.541666666666664,55.378051,-3.435973
2008,United States,4,5,9,44.44444444444444,260,253,513,50.682261208576996,37.09024,-95.712891
2009,Argentina,4,7,11,36.36363636363637,212,227,439,48.29157175398633,-38.416097,-63.616672
2009,Australia,1,1,2,50,53,49,102,51.9607843137255,-25.274398,133.775136
2009,Brazil,1,1,2,50,32,48,80,40,-14.235004,-51.92528
2009,Croatia,3,3,6,50,123,87,210,58.57142857142858,45.1,15.2
2009,Czech Republic,3,1,4,75,102,92,194,52.57731958762887,49.817492,15.472962
2009,France,6,8,14,42.857142857142854,370,339,709,52.186177715091674,46.227638,2.213749
2009,Germany,2,4,6,33.33333333333333,210,251,461,45.5531453362256,51.165691,10.451526
2009,Russia,7,3,10,70,194,184,378,51.32275132275132,61.52401,105.318756
2009,Serbia,7,7,14,50,141,77,218,64.6788990825688,44.016521,21.005859
2009,Spain,13,8,21,61.904761904761905,417,356,773,53.94566623544631,40.463667,-3.74922
2009,Sweden,1,1,2,50,57,41,98,58.16326530612245,60.128161,18.643501
2009,Switzerland,4,3,7,57.14285714285714,105,56,161,65.21739130434783,46.818188,8.227512
2009,United Kingdom,6,1,7,85.71428571428571,70,29,99,70.70707070707071,55.378051,-3.435973
2009,United States,5,11,16,31.25,240,235,475,50.526315789473685,37.09024,-95.712891
2010,Argentina,5,1,6,83.33333333333334,144,161,305,47.21311475409836,-38.416097,-63.616672
2010,Austria,1,2,3,33.33333333333333,67,52,119,56.30252100840336,47.516231,14.550072
2010,Croatia,3,3,6,50,99,69,168,58.92857142857143,45.1,15.2
2010,Cyprus,1,2,3,33.33333333333333,43,33,76,56.57894736842105,35.126413,33.429859
2010,France,5,8,13,38.46153846153847,300,305,605,49.586776859504134,46.227638,2.213749
2010,Kazakhstan,2,1,3,66.66666666666666,57,51,108,52.77777777777778,48.019573,66.923684
2010,Russia,3,3,6,50,115,111,226,50.88495575221239,61.52401,105.318756
2010,Serbia,3,3,6,50,131,83,214,61.21495327102804,44.016521,21.005859
2010,Spain,20,11,31,64.51612903225806,439,319,758,57.9155672823219,40.463667,-3.74922
2010,Sweden,2,3,5,40,61,34,95,64.21052631578948,60.128161,18.643501
2010,Switzerland,6,5,11,54.54545454545454,120,69,189,63.49206349206349,46.818188,8.227512
2010,United Kingdom,2,2,4,50,56,31,87,64.36781609195403,55.378051,-3.435973
2010,United States,9,10,19,47.368421052631575,239,231,470,50.851063829787236,37.09024,-95.712891
2011,Argentina,3,5,8,37.5,173,160,333,51.95195195195195,-38.416097,-63.616672
2011,Canada,1,1,2,50,43,36,79,54.43037974683544,56.130366,-106.346771
2011,Croatia,2,5,7,28.57142857142857,116,100,216,53.70370370370371,45.1,15.2
2011,France,5,6,11,45.45454545454545,273,260,533,51.21951219512195,46.227638,2.213749
2011,Germany,3,4,7,42.857142857142854,177,245,422,41.943127962085306,51.165691,10.451526
2011,Italy,1,1,2,50,105,128,233,45.06437768240343,41.87194,12.56738
2011,Russia,2,1,3,66.66666666666666,146,170,316,46.20253164556962,61.52401,105.318756
2011,Serbia,12,6,18,66.66666666666666,170,66,236,72.03389830508475,44.016521,21.005859
2011,Spain,13,20,33,39.39393939393939,423,330,753,56.17529880478087,40.463667,-3.74922
2011,Switzerland,5,2,7,71.42857142857143,104,44,148,70.27027027027027,46.818188,8.227512
2011,Ukraine,1,1,2,50,71,73,144,49.30555555555556,48.379433,31.16558
2011,United Kingdom,5,1,6,83.33333333333334,68,29,97,70.10309278350515,55.378051,-3.435973
2011,United States,5,5,10,50,222,206,428,51.86915887850467,37.09024,-95.712891
2012,Argentina,8,4,12,66.66666666666666,187,144,331,56.49546827794561,-38.416097,-63.616672
2012,Brazil,1,1,2,50,42,44,86,48.837209302325576,-14.235004,-51.92528
2012,Canada,2,2,4,50,60,60,120,50,56.130366,-106.346771
2012,Croatia,2,1,3,66.66666666666666,79,81,160,49.375,45.1,15.2
2012,Czech Republic,2,4,6,33.33333333333333,111,79,190,58.42105263157895,49.817492,15.472962
2012,France,4,11,15,26.666666666666668,313,267,580,53.96551724137931,46.227638,2.213749
2012,Germany,2,4,6,33.33333333333333,166,202,368,45.108695652173914,51.165691,10.451526
2012,Italy,2,5,7,28.57142857142857,113,150,263,42.96577946768061,41.87194,12.56738
2012,Serbia,9,7,16,56.25,162,74,236,68.64406779661016,44.016521,21.005859
2012,Slovakia,1,1,2,50,37,48,85,43.529411764705884,48.669026,19.699024
2012,Spain,14,7,21,66.66666666666666,362,297,659,54.93171471927162,40.463667,-3.74922
2012,Switzerland,6,4,10,60,113,48,161,70.1863354037267,46.818188,8.227512
2012,Ukraine,1,2,3,33.33333333333333,58,62,120,48.333333333333336,48.379433,31.16558
2012,United Kingdom,3,4,7,42.857142857142854,64,36,100,64,55.378051,-3.435973
2012,United States,5,3,8,62.5,229,236,465,49.24731182795699,37.09024,-95.712891
2013,Argentina,7,5,12,58.333333333333336,168,152,320,52.5,-38.416097,-63.616672
2013,Australia,1,1,2,50,84,99,183,45.90163934426229,-25.274398,133.775136
2013,Austria,1,1,2,50,32,44,76,42.10526315789473,47.516231,14.550072
2013,Bulgaria,1,1,2,50,39,25,64,60.9375,42.733883,25.48583
2013,Canada,2,2,4,50,73,60,133,54.88721804511278,56.130366,-106.346771
2013,Croatia,2,1,3,66.66666666666666,74,69,143,51.74825174825175,45.1,15.2
2013,Czech Republic,1,3,4,25,109,98,207,52.65700483091788,49.817492,15.472962
2013,France,7,8,15,46.666666666666664,330,298,628,52.547770700636946,46.227638,2.213749
2013,Germany,2,4,6,33.33333333333333,186,197,383,48.56396866840731,51.165691,10.451526
2013,Italy,2,1,3,66.66666666666666,103,121,224,45.982142857142854,41.87194,12.56738
2013,Russia,2,2,4,50,128,129,257,49.80544747081712,61.52401,105.318756
2013,Serbia,8,2,10,80,113,65,178,63.48314606741573,44.016521,21.005859
2013,Spain,17,18,35,48.57142857142857,433,316,749,57.810413885180246,40.463667,-3.74922
2013,Switzerland,2,5,7,28.57142857142857,101,53,154,65.5844155844156,46.818188,8.227512
2013,United Kingdom,4,1,5,80,51,24,75,68,55.378051,-3.435973
2013,United States,2,2,4,50,149,198,347,42.93948126801153,37.09024,-95.712891
2014,Argentina,4,3,7,57.14285714285714,116,122,238,48.739495798319325,-38.416097,-63.616672
2014,Australia,3,1,4,75,90,119,209,43.0622009569378,-25.274398,133.775136
2014,Belgium,2,1,3,66.66666666666666,25,22,47,53.191489361702125,50.503887,4.469936
2014,Bulgaria,3,1,4,75,56,24,80,70,42.733883,25.48583
2014,Canada,1,3,4,25,76,64,140,54.285714285714285,56.130366,-106.346771
2014,Croatia,4,5,9,44.44444444444444,118,92,210,56.19047619047619,45.1,15.2
2014,Czech Republic,3,5,8,37.5,119,91,210,56.666666666666664,49.817492,15.472962
2014,France,2,7,9,22.22222222222222,296,304,600,49.333333333333336,46.227638,2.213749
2014,Germany,1,2,3,33.33333333333333,152,172,324,46.913580246913575,51.165691,10.451526
2014,Italy,1,3,4,25,84,105,189,44.44444444444444,41.87194,12.56738
2014,Japan,4,2,6,66.66666666666666,61,40,101,60.396039603960396,36.204824,138.252924
2014,Serbia,7,1,8,87.5,97,39,136,71.32352941176471,44.016521,21.005859
2014,Spain,11,13,24,45.83333333333333,400,322,722,55.4016620498615,40.463667,-3.74922
2014,Switzerland,8,6,14,57.14285714285714,119,41,160,74.375,46.818188,8.227512
2015,Australia,1,1,2,50,122,149,271,45.018450184501845,-25.274398,133.775136
2015,Canada,1,1,2,50,58,48,106,54.71698113207547,56.130366,-106.346771
2015,Croatia,2,1,3,66.66666666666666,108,96,204,52.94117647058824,45.1,15.2
2015,Czech Republic,3,4,7,42.857142857142854,111,94,205,54.146341463414636,49.817492,15.472962
2015,France,6,8,14,42.857142857142854,284,242,526,53.99239543726235,46.227638,2.213749
2015,Germany,1,1,2,50,99,151,250,39.6,51.165691,10.451526
2015,Japan,3,1,4,75,77,65,142,54.22535211267606,36.204824,138.252924
2015,Portugal,1,3,4,25,43,38,81,53.086419753086425,39.399872,-8.224454
2015,Serbia,12,5,17,70.58823529411765,142,76,218,65.13761467889908,44.016521,21.005859
2015,South Africa,1,2,3,33.33333333333333,51,27,78,65.38461538461539,-30.559482,22.937506
2015,Spain,10,11,21,47.61904761904761,372,313,685,54.30656934306569,40.463667,-3.74922
2015,Switzerland,10,5,15,66.66666666666666,122,38,160,76.25,46.818188,8.227512
2015,United Kingdom,4,3,7,57.14285714285714,77,36,113,68.14159292035397,55.378051,-3.435973
2015,United States,3,6,9,33.33333333333333,200,200,400,50,37.09024,-95.712891
2015,Uruguay,1,1,2,50,31,30,61,50.81967213114754,-32.522779,-55.765835
2016,Argentina,4,3,7,57.14285714285714,151,161,312,48.3974358974359,-38.416097,-63.616672
2016,Australia,3,1,4,75,108,115,223,48.4304932735426,-25.274398,133.775136
2016,Austria,4,2,6,66.66666666666666,68,40,108,62.96296296296296,47.516231,14.550072
2016,Canada,1,3,4,25,71,55,126,56.34920634920635,56.130366,-106.346771
2016,Croatia,4,5,9,44.44444444444444,114,98,212,53.77358490566038,45.1,15.2
2016,France,5,6,11,45.45454545454545,332,296,628,52.86624203821656,46.227638,2.213749
2016,Germany,3,3,6,50,147,150,297,49.494949494949495,51.165691,10.451526
2016,Italy,2,1,3,66.66666666666666,86,116,202,42.57425742574257,41.87194,12.56738
2016,Japan,1,4,5,20,87,66,153,56.86274509803921,36.204824,138.252924
2016,Serbia,8,4,12,66.66666666666666,129,79,208,62.019230769230774,44.016521,21.005859
2016,Slovakia,2,1,3,66.66666666666666,32,36,68,47.05882352941176,48.669026,19.699024
2016,Spain,10,9,19,52.63157894736842,369,327,696,53.01724137931034,40.463667,-3.74922
2016,Switzerland,4,2,6,66.66666666666666,74,42,116,63.793103448275865,46.818188,8.227512
2016,United Kingdom,9,4,13,69.23076923076923,112,49,161,69.56521739130434,55.378051,-3.435973
2016,United States,2,7,9,22.22222222222222,236,278,514,45.91439688715953,37.09024,-95.712891
2016,Uruguay,2,2,4,50,35,26,61,57.377049180327866,-32.522779,-55.765835
2017,Argentina,2,3,5,40,173,173,346,50,-38.416097,-63.616672
2017,Austria,1,2,3,33.33333333333333,60,45,105,57.14285714285714,47.516231,14.550072
2017,Belgium,2,3,5,40,87,57,144,60.416666666666664,50.503887,4.469936
2017,Bosnia and Herzegovina,2,1,3,66.66666666666666,42,27,69,60.86956521739131,43.915886,17.679076
2017,Bulgaria,4,1,5,80,49,21,70,70,42.733883,25.48583
2017,Croatia,2,3,5,40,89,80,169,52.662721893491124,45.1,15.2
2017,France,7,7,14,50,273,275,548,49.81751824817518,46.227638,2.213749
2017,Germany,7,5,12,58.333333333333336,204,202,406,50.24630541871922,51.165691,10.451526
2017,Italy,1,3,4,25,98,126,224,43.75,41.87194,12.56738
2017,Japan,1,2,3,33.33333333333333,68,57,125,54.400000000000006,36.204824,138.252924
2017,Luxembourg,2,1,3,66.66666666666666,32,18,50,64,49.815273,6.129583
2017,Russia,1,2,3,33.33333333333333,105,153,258,40.69767441860465,61.52401,105.318756
2017,Serbia,2,2,4,50,95,82,177,53.672316384180796,44.016521,21.005859
2017,Spain,11,9,20,55.00000000000001,296,227,523,56.59655831739961,40.463667,-3.74922
2017,Switzerland,8,3,11,72.72727272727273,92,36,128,71.875,46.818188,8.227512
2017,Ukraine,1,2,3,33.33333333333333,34,41,75,45.33333333333333,48.379433,31.16558
2017,United Kingdom,1,2,3,33.33333333333333,73,61,134,54.47761194029851,55.378051,-3.435973
2017,United States,9,1,10,90,269,277,546,49.26739926739927,37.09024,-95.712891
2018,Argentina,3,6,9,33.33333333333333,170,151,321,52.95950155763239,-38.416097,-63.616672
2018,Australia,2,4,6,33.33333333333333,110,129,239,46.02510460251046,-25.274398,133.775136
2018,Austria,3,2,5,60,67,47,114,58.77192982456141,47.516231,14.550072
2018,Croatia,2,2,4,50,98,62,160,61.25000000000001,45.1,15.2
2018,France,5,10,15,33.33333333333333,252,257,509,49.50884086444008,46.227638,2.213749
2018,Germany,5,6,11,45.45454545454545,187,195,382,48.952879581151834,51.165691,10.451526
2018,Greece,2,2,4,50,46,27,73,63.013698630136986,39.074208,21.824312
2018,Italy,6,1,7,85.71428571428571,145,145,290,50,41.87194,12.56738
2018,Japan,2,3,5,40,80,77,157,50.955414012738856,36.204824,138.252924
2018,Russia,6,1,7,85.71428571428571,129,111,240,53.75,61.52401,105.318756
2018,Serbia,4,3,7,57.14285714285714,111,85,196,56.63265306122449,44.016521,21.005859
2018,Slovakia,1,2,3,33.33333333333333,42,40,82,51.21951219512195,48.669026,19.699024
2018,South Africa,2,3,5,40,50,24,74,67.56756756756756,-30.559482,22.937506
2018,Spain,9,3,12,75,256,225,481,53.222453222453225,40.463667,-3.74922
2018,Switzerland,4,3,7,57.14285714285714,75,37,112,66.96428571428571,46.818188,8.227512
2018,United Kingdom,1,1,2,50,66,52,118,55.932203389830505,55.378051,-3.435973
2018,United States,5,6,11,45.45454545454545,253,305,558,45.340501792114694,37.09024,-95.712891
2019,Argentina,3,4,7,42.857142857142854,148,144,292,50.68493150684932,-38.416097,-63.616672
2019,Australia,5,3,8,62.5,139,147,286,48.6013986013986,-25.274398,133.775136
2019,Austria,5,2,7,71.42857142857143,54,32,86,62.7906976744186,47.516231,14.550072
2019,Canada,1,5,6,16.666666666666664,107,82,189,56.613756613756614,56.130366,-106.346771
2019,Chile,3,2,5,60,51,45,96,53.125,-35.675147,-71.542969
2019,France,6,5,11,54.54545454545454,283,273,556,50.89928057553957,46.227638,2.213749
2019,Germany,1,3,4,25,143,162,305,46.885245901639344,51.165691,10.451526
2019,Greece,3,3,6,50,54,25,79,68.35443037974683,39.074208,21.824312
2019,Italy,5,2,7,71.42857142857143,165,186,351,47.008547008547005,41.87194,12.56738
2019,Russia,5,6,11,45.45454545454545,131,80,211,62.08530805687204,61.52401,105.318756
2019,Serbia,7,5,12,58.333333333333336,165,115,280,58.92857142857143,44.016521,21.005859
2019,Spain,8,3,11,72.72727272727273,278,226,504,55.158730158730165,40.463667,-3.74922
2019,Switzerland,4,4,8,50,93,47,140,66.42857142857143,46.818188,8.227512
2019,United Kingdom,1,2,3,33.33333333333333,70,84,154,45.45454545454545,55.378051,-3.435973
2019,United States,4,4,8,50,201,250,451,44.567627494456765,37.09024,-95.712891
2020,Australia,1,1,2,50,60,65,125,48,-25.274398,133.775136
2020,Austria,1,2,3,33.33333333333333,34,25,59,57.6271186440678,47.516231,14.550072
2020,France,4,3,7,57.14285714285714,117,126,243,48.148148148148145,46.227638,2.213749
2020,Germany,2,3,5,40,73,59,132,55.3030303030303,51.165691,10.451526
2020,Greece,1,2,3,33.33333333333333,32,14,46,69.56521739130434,39.074208,21.824312
2020,Italy,1,4,5,20,89,107,196,45.40816326530612,41.87194,12.56738
2020,Norway,1,1,2,50,24,16,40,60,60.472024,8.468946
2020,Serbia,7,2,9,77.77777777777779,106,61,167,63.47305389221557,44.016521,21.005859
2020,Spain,3,1,4,75,126,108,234,53.84615384615385,40.463667,-3.74922
2020,United States,1,1,2,50,108,131,239,45.18828451882845,37.09024,-95.712891
2021,Argentina,2,2,4,50,47,54,101,46.53465346534654,-38.416097,-63.616672
2021,Greece,1,2,3,33.33333333333333,27,7,34,79.41176470588235,39.074208,21.824312
2021,Italy,3,4,7,42.857142857142854,82,81,163,50.306748466257666,41.87194,12.56738
2021,Russia,5,3,8,62.5,74,26,100,74,61.52401,105.318756
2021,Serbia,1,1,2,50,44,42,86,51.162790697674424,44.016521,21.005859
2021,Spain,2,4,6,33.33333333333333,94,78,172,54.65116279069767,40.463667,-3.74922
1969,Argentina,0,0,0,0,5,13,18,27.77777777777778,-38.416097,-63.616672
1969,Austria,0,0,0,0,6,9,15,40,47.516231,14.550072
1969,Belgium,0,0,0,0,2,15,17,11.76470588235294,50.503887,4.469936
1969,Brazil,0,0,0,0,27,21,48,56.25,-14.235004,-51.92528
1969,Bulgaria,0,0,0,0,2,2,4,50,42.733883,25.48583
1969,Canada,0,0,0,0,30,42,72,41.66666666666667,56.130366,-106.346771
1969,Chile,0,0,0,0,44,48,92,47.82608695652174,-35.675147,-71.542969
1969,Colombia,0,0,0,0,4,9,13,30.76923076923077,4.570868,-74.297333
1969,Czech Republic,0,0,0,0,51,39,90,56.666666666666664,49.817492,15.472962
1969,Denmark,0,0,0,0,9,15,24,37.5,56.26392,9.501785
1969,Ecuador,0,0,0,0,15,21,36,41.66666666666667,-1.831239,-78.183406
1969,Egypt,0,0,0,0,58,12,70,82.85714285714286,26.820553,30.802498
1969,Estonia,0,0,0,0,3,2,5,60,58.595272,25.013607
1969,Finland,0,0,0,0,1,3,4,25,61.92411,25.748151
1969,Germany,0,0,0,0,41,44,85,48.23529411764706,51.165691,10.451526
1969,Greece,0,0,0,0,4,9,13,30.76923076923077,39.074208,21.824312
1969,Hungary,0,0,0,0,9,11,20,45,47.162494,19.503304
1969,India,0,0,0,0,19,16,35,54.285714285714285,20.593684,78.96288
1969,Ireland,0,0,0,0,8,25,33,24.242424242424242,53.41291,-8.24389
1969,Israel,0,0,0,0,4,6,10,40,31.046051,34.851612
1969,Italy,0,0,0,0,29,57,86,33.72093023255814,41.87194,12.56738
1969,Jamaica,0,0,0,0,4,13,17,23.52941176470588,18.109581,-77.297508
1969,Japan,0,0,0,0,7,17,24,29.166666666666668,36.204824,138.252924
1969,Mexico,0,0,0,0,13,19,32,40.625,23.634501,-102.552784
1969,Monaco,0,0,0,0,2,6,8,25,43.750298,7.412841
1969,New Zealand,0,0,0,0,16,32,48,33.33333333333333,-40.900557,174.885971
1969,Philippines,0,0,0,0,2,4,6,33.33333333333333,12.879721,121.774017
1969,Poland,0,0,0,0,9,10,19,47.368421052631575,51.919438,19.145136
1969,Portugal,0,0,0,0,1,4,5,20,39.399872,-8.224454
1969,Russia,0,0,0,0,24,21,45,53.333333333333336,61.52401,105.318756
1969,Serbia,0,0,0,0,3,9,12,25,44.016521,21.005859
1969,South Korea,0,0,0,0,2,2,4,50,35.907757,127.766922
1969,Sweden,0,0,0,0,12,24,36,33.33333333333333,60.128161,18.643501
1969,Switzerland,0,0,0,0,1,12,13,7.6923076923076925,46.818188,8.227512
1969,United Arab Emirates,0,0,0,0,36,1,37,97.2972972972973,23.424076,53.847818
1969,United Kingdom,0,0,0,0,107,98,205,52.19512195121951,55.378051,-3.435973
1969,Vatican City,0,0,0,0,36,52,88,40.909090909090914,41.902916,12.453389
1969,Venezuela,0,0,0,0,5,7,12,41.66666666666667,6.42375,-66.58973
1969,Vietnam,0,0,0,0,2,2,4,50,14.058324,108.277199
1969,Zimbabwe,0,0,0,0,3,6,9,33.33333333333333,-19.015438,29.154857
1970,Argentina,0,0,0,0,7,24,31,22.58064516129032,-38.416097,-63.616672
1970,Austria,0,0,0,0,10,24,34,29.411764705882355,47.516231,14.550072
1970,Belgium,0,0,0,0,8,19,27,29.629629629629626,50.503887,4.469936
1970,Brazil,0,0,0,0,25,25,50,50,-14.235004,-51.92528
1970,Bulgaria,0,0,0,0,4,4,8,50,42.733883,25.48583
1970,Canada,0,0,0,0,13,15,28,46.42857142857143,56.130366,-106.346771
1970,Chile,0,0,0,0,50,50,100,50,-35.675147,-71.542969
1970,Colombia,0,0,0,0,4,10,14,28.57142857142857,4.570868,-74.297333
1970,Denmark,0,0,0,0,15,28,43,34.883720930232556,56.26392,9.501785
1970,Ecuador,0,0,0,0,9,22,31,29.03225806451613,-1.831239,-78.183406
1970,Egypt,0,0,0,0,22,30,52,42.30769230769231,26.820553,30.802498
1970,Finland,0,0,0,0,2,5,7,28.57142857142857,61.92411,25.748151
1970,France,0,0,0,0,102,132,234,43.58974358974359,46.227638,2.213749
1970,Greece,0,0,0,0,9,10,19,47.368421052631575,39.074208,21.824312
1970,Hungary,0,0,0,0,26,29,55,47.27272727272727,47.162494,19.503304
1970,India,0,0,0,0,25,33,58,43.103448275862064,20.593684,78.96288
1970,Indonesia,0,0,0,0,1,11,12,8.333333333333332,-0.789275,113.921327
1970,Iran,0,0,0,0,1,4,5,20,32.427908,53.688046
1970,Ireland,0,0,0,0,41,23,64,64.0625,53.41291,-8.24389
1970,Italy,0,0,0,0,11,27,38,28.947368421052634,41.87194,12.56738
1970,Jamaica,0,0,0,0,4,19,23,17.391304347826086,18.109581,-77.297508
1970,Japan,0,0,0,0,9,16,25,36,36.204824,138.252924
1970,Mexico,0,0,0,0,60,30,90,66.66666666666666,23.634501,-102.552784
1970,Monaco,0,0,0,0,3,5,8,37.5,43.750298,7.412841
1970,New Zealand,0,0,0,0,45,44,89,50.56179775280899,-40.900557,174.885971
1970,Pakistan,0,0,0,0,7,11,18,38.88888888888889,30.375321,69.345116
1970,Peru,0,0,0,0,2,4,6,33.33333333333333,-9.189967,-75.015152
1970,Poland,0,0,0,0,5,8,13,38.46153846153847,51.919438,19.145136
1970,Russia,0,0,0,0,29,28,57,50.877192982456144,61.52401,105.318756
1970,Serbia,0,0,0,0,19,18,37,51.35135135135135,44.016521,21.005859
1970,Sri Lanka,0,0,0,0,2,4,6,33.33333333333333,7.873054,80.771797
1970,Sweden,0,0,0,0,6,21,27,22.22222222222222,60.128161,18.643501
1970,Switzerland,0,0,0,0,6,13,19,31.57894736842105,46.818188,8.227512
1970,Venezuela,0,0,0,0,1,3,4,25,6.42375,-66.58973
1970,Vietnam,0,0,0,0,2,4,6,33.33333333333333,14.058324,108.277199
1971,Argentina,0,0,0,0,13,21,34,38.23529411764706,-38.416097,-63.616672
1971,Austria,0,0,0,0,12,22,34,35.294117647058826,47.516231,14.550072
1971,Belgium,0,0,0,0,13,22,35,37.142857142857146,50.503887,4.469936
1971,Brazil,0,0,0,0,45,32,77,58.44155844155844,-14.235004,-51.92528
1971,Canada,0,0,0,0,20,20,40,50,56.130366,-106.346771
1971,Chile,0,0,0,0,68,61,129,52.71317829457365,-35.675147,-71.542969
1971,Colombia,0,0,0,0,3,8,11,27.27272727272727,4.570868,-74.297333
1971,Denmark,0,0,0,0,38,60,98,38.775510204081634,56.26392,9.501785
1971,Ecuador,0,0,0,0,9,14,23,39.130434782608695,-1.831239,-78.183406
1971,Egypt,0,0,0,0,28,40,68,41.17647058823529,26.820553,30.802498
1971,Finland,0,0,0,0,5,4,9,55.55555555555556,61.92411,25.748151
1971,France,0,0,0,0,190,152,342,55.55555555555556,46.227638,2.213749
1971,Germany,0,0,0,0,54,79,133,40.6015037593985,51.165691,10.451526
1971,Greece,0,0,0,0,5,10,15,33.33333333333333,39.074208,21.824312
1971,Hungary,0,0,0,0,38,37,75,50.66666666666667,47.162494,19.503304
1971,India,0,0,0,0,11,22,33,33.33333333333333,20.593684,78.96288
1971,Indonesia,0,0,0,0,5,6,11,45.45454545454545,-0.789275,113.921327
1971,Ireland,0,0,0,0,6,27,33,18.181818181818183,53.41291,-8.24389
1971,Israel,0,0,0,0,4,4,8,50,31.046051,34.851612
1971,Italy,0,0,0,0,73,96,169,43.19526627218935,41.87194,12.56738
1971,Jamaica,0,0,0,0,10,22,32,31.25,18.109581,-77.297508
1971,Japan,0,0,0,0,27,40,67,40.298507462686565,36.204824,138.252924
1971,Luxembourg,0,0,0,0,4,4,8,50,49.815273,6.129583
1971,Mexico,0,0,0,0,26,36,62,41.935483870967744,23.634501,-102.552784
1971,New Zealand,0,0,0,0,51,70,121,42.14876033057851,-40.900557,174.885971
1971,Pakistan,0,0,0,0,20,17,37,54.054054054054056,30.375321,69.345116
1971,Peru,0,0,0,0,15,14,29,51.724137931034484,-9.189967,-75.015152
1971,Philippines,0,0,0,0,1,3,4,25,12.879721,121.774017
1971,Poland,0,0,0,0,6,10,16,37.5,51.919438,19.145136
1971,Portugal,0,0,0,0,2,3,5,40,39.399872,-8.224454
1971,Russia,0,0,0,0,29,14,43,67.44186046511628,61.52401,105.318756
1971,Serbia,0,0,0,0,9,20,29,31.03448275862069,44.016521,21.005859
1971,Sweden,0,0,0,0,16,36,52,30.76923076923077,60.128161,18.643501
1971,Turkey,0,0,0,0,1,3,4,25,38.963745,35.243322
1971,Ukraine,0,0,0,0,1,1,2,50,48.379433,31.16558
1971,Vatican City,0,0,0,0,1,2,3,33.33333333333333,41.902916,12.453389
1971,Venezuela,0,0,0,0,1,6,7,14.285714285714285,6.42375,-66.58973
1971,Zimbabwe,0,0,0,0,8,11,19,42.10526315789473,-19.015438,29.154857
1972,Argentina,0,0,0,0,24,28,52,46.15384615384615,-38.416097,-63.616672
1972,Austria,0,0,0,0,9,19,28,32.142857142857146,47.516231,14.550072
1972,Belgium,0,0,0,0,24,25,49,48.97959183673469,50.503887,4.469936
1972,Brazil,0,0,0,0,28,29,57,49.122807017543856,-14.235004,-51.92528
1972,Canada,0,0,0,0,9,34,43,20.930232558139537,56.130366,-106.346771
1972,Chile,0,0,0,0,74,76,150,49.333333333333336,-35.675147,-71.542969
1972,Colombia,0,0,0,0,11,18,29,37.93103448275862,4.570868,-74.297333
1972,Denmark,0,0,0,0,6,20,26,23.076923076923077,56.26392,9.501785
1972,Ecuador,0,0,0,0,1,5,6,16.666666666666664,-1.831239,-78.183406
1972,Egypt,0,0,0,0,24,30,54,44.44444444444444,26.820553,30.802498
1972,Finland,0,0,0,0,2,3,5,40,61.92411,25.748151
1972,France,0,0,0,0,174,176,350,49.714285714285715,46.227638,2.213749
1972,Greece,0,0,0,0,4,13,17,23.52941176470588,39.074208,21.824312
1972,Hungary,0,0,0,0,34,50,84,40.476190476190474,47.162494,19.503304
1972,India,0,0,0,0,31,43,74,41.891891891891895,20.593684,78.96288
1972,Indonesia,0,0,0,0,1,2,3,33.33333333333333,-0.789275,113.921327
1972,Iran,0,0,0,0,7,5,12,58.333333333333336,32.427908,53.688046
1972,Ireland,0,0,0,0,47,57,104,45.19230769230769,53.41291,-8.24389
1972,Italy,0,0,0,0,57,78,135,42.22222222222222,41.87194,12.56738
1972,Jamaica,0,0,0,0,4,10,14,28.57142857142857,18.109581,-77.297508
1972,Japan,0,0,0,0,39,49,88,44.31818181818182,36.204824,138.252924
1972,Luxembourg,0,0,0,0,2,6,8,25,49.815273,6.129583
1972,Mexico,0,0,0,0,16,29,45,35.55555555555556,23.634501,-102.552784
1972,Monaco,0,0,0,0,4,8,12,33.33333333333333,43.750298,7.412841
1972,Morocco,0,0,0,0,8,4,12,66.66666666666666,31.791702,-7.09262
1972,New Zealand,0,0,0,0,62,95,157,39.490445859872615,-40.900557,174.885971
1972,Pakistan,0,0,0,0,30,34,64,46.875,30.375321,69.345116
1972,Poland,0,0,0,0,10,10,20,50,51.919438,19.145136
1972,Portugal,0,0,0,0,1,2,3,33.33333333333333,39.399872,-8.224454
1972,Russia,0,0,0,0,55,19,74,74.32432432432432,61.52401,105.318756
1972,Serbia,0,0,0,0,3,13,16,18.75,44.016521,21.005859
1972,Sweden,0,0,0,0,38,60,98,38.775510204081634,60.128161,18.643501
1972,Vatican City,0,0,0,0,2,4,6,33.33333333333333,41.902916,12.453389
1972,Venezuela,0,0,0,0,6,9,15,40,6.42375,-66.58973
1972,Vietnam,0,0,0,0,6,2,8,75,14.058324,108.277199
1972,Zimbabwe,0,0,0,0,2,4,6,33.33333333333333,-19.015438,29.154857
1973,Argentina,0,0,0,0,80,51,131,61.06870229007634,-38.416097,-63.616672
1973,Austria,0,0,0,0,20,31,51,39.21568627450981,47.516231,14.550072
1973,Belgium,0,0,0,0,18,18,36,50,50.503887,4.469936
1973,Brazil,0,0,0,0,8,28,36,22.22222222222222,-14.235004,-51.92528
1973,Bulgaria,0,0,0,0,6,6,12,50,42.733883,25.48583
1973,Canada,0,0,0,0,8,31,39,20.51282051282051,56.130366,-106.346771
1973,Colombia,0,0,0,0,23,22,45,51.11111111111111,4.570868,-74.297333
1973,Costa Rica,0,0,0,0,4,3,7,57.14285714285714,9.748917,-83.753428
1973,Croatia,0,0,0,0,74,65,139,53.23741007194245,45.1,15.2
1973,Denmark,0,0,0,0,11,28,39,28.205128205128204,56.26392,9.501785
1973,Ecuador,0,0,0,0,4,6,10,40,-1.831239,-78.183406
1973,Egypt,0,0,0,0,19,28,47,40.42553191489361,26.820553,30.802498
1973,Finland,0,0,0,0,2,3,5,40,61.92411,25.748151
1973,France,0,0,0,0,212,206,418,50.717703349282296,46.227638,2.213749
1973,Greece,0,0,0,0,15,27,42,35.714285714285715,39.074208,21.824312
1973,Hungary,0,0,0,0,53,77,130,40.76923076923077,47.162494,19.503304
1973,Indonesia,0,0,0,0,8,9,17,47.05882352941176,-0.789275,113.921327
1973,Iran,0,0,0,0,1,9,10,10,32.427908,53.688046
1973,Ireland,0,0,0,0,3,22,25,12,53.41291,-8.24389
1973,Israel,0,0,0,0,1,3,4,25,31.046051,34.851612
1973,Jamaica,0,0,0,0,6,10,16,37.5,18.109581,-77.297508
1973,Japan,0,0,0,0,37,70,107,34.57943925233645,36.204824,138.252924
1973,Mexico,0,0,0,0,61,71,132,46.21212121212121,23.634501,-102.552784
1973,Morocco,0,0,0,0,3,5,8,37.5,31.791702,-7.09262
1973,Niger,0,0,0,0,1,1,2,50,17.607789,8.081666
1973,Nigeria,0,0,0,0,1,1,2,50,9.081999,8.675277
1973,Norway,0,0,0,0,7,5,12,58.333333333333336,60.472024,8.468946
1973,Pakistan,0,0,0,0,28,46,74,37.83783783783784,30.375321,69.345116
1973,Peru,0,0,0,0,3,11,14,21.428571428571427,-9.189967,-75.015152
1973,Poland,0,0,0,0,8,9,17,47.05882352941176,51.919438,19.145136
1973,Russia,0,0,0,0,44,31,75,58.666666666666664,61.52401,105.318756
1973,Serbia,0,0,0,0,5,13,18,27.77777777777778,44.016521,21.005859
1973,South Africa,0,0,0,0,160,187,347,46.10951008645533,-30.559482,22.937506
1973,South Korea,0,0,0,0,1,3,4,25,35.907757,127.766922
1973,Sweden,0,0,0,0,105,106,211,49.763033175355446,60.128161,18.643501
1973,Switzerland,0,0,0,0,6,7,13,46.15384615384615,46.818188,8.227512
1973,Turkey,0,0,0,0,6,6,12,50,38.963745,35.243322
1973,Venezuela,0,0,0,0,3,11,14,21.428571428571427,6.42375,-66.58973
1973,Vietnam,0,0,0,0,3,3,6,50,14.058324,108.277199
1974,Austria,0,0,0,0,25,31,56,44.642857142857146,47.516231,14.550072
1974,Belgium,0,0,0,0,13,6,19,68.42105263157895,50.503887,4.469936
1974,Bolivia,0,0,0,0,2,9,11,18.181818181818183,-16.290154,-63.588653
1974,Brazil,0,0,0,0,34,32,66,51.515151515151516,-14.235004,-51.92528
1974,Bulgaria,0,0,0,0,5,2,7,71.42857142857143,42.733883,25.48583
1974,Canada,0,0,0,0,2,22,24,8.333333333333332,56.130366,-106.346771
1974,Chile,0,0,0,0,86,121,207,41.54589371980676,-35.675147,-71.542969
1974,Colombia,0,0,0,0,23,33,56,41.07142857142857,4.570868,-74.297333
1974,Croatia,0,0,0,0,47,52,99,47.474747474747474,45.1,15.2
1974,Czech Republic,0,0,0,0,111,125,236,47.03389830508475,49.817492,15.472962
1974,Denmark,0,0,0,0,9,30,39,23.076923076923077,56.26392,9.501785
1974,Egypt,0,0,0,0,46,31,77,59.74025974025974,26.820553,30.802498
1974,Finland,0,0,0,0,6,7,13,46.15384615384615,61.92411,25.748151
1974,France,0,0,0,0,119,175,294,40.476190476190474,46.227638,2.213749
1974,Greece,0,0,0,0,2,20,22,9.090909090909092,39.074208,21.824312
1974,Hungary,0,0,0,0,31,34,65,47.69230769230769,47.162494,19.503304
1974,Indonesia,0,0,0,0,2,9,11,18.181818181818183,-0.789275,113.921327
1974,Iran,0,0,0,0,8,11,19,42.10526315789473,32.427908,53.688046
1974,Ireland,0,0,0,0,1,4,5,20,53.41291,-8.24389
1974,Israel,0,0,0,0,5,8,13,38.46153846153847,31.046051,34.851612
1974,Jamaica,0,0,0,0,1,3,4,25,18.109581,-77.297508
1974,Japan,0,0,0,0,61,88,149,40.939597315436245,36.204824,138.252924
1974,Malaysia,0,0,0,0,1,7,8,12.5,4.210484,101.975766
1974,Monaco,0,0,0,0,5,3,8,62.5,43.750298,7.412841
1974,Niger,0,0,0,0,1,2,3,33.33333333333333,17.607789,8.081666
1974,Nigeria,0,0,0,0,4,1,5,80,9.081999,8.675277
1974,Norway,0,0,0,0,4,10,14,28.57142857142857,60.472024,8.468946
1974,Pakistan,0,0,0,0,20,30,50,40,30.375321,69.345116
1974,Paraguay,0,0,0,0,2,4,6,33.33333333333333,-23.442503,-58.443832
1974,Philippines,0,0,0,0,12,16,28,42.857142857142854,12.879721,121.774017
1974,Poland,0,0,0,0,19,21,40,47.5,51.919438,19.145136
1974,Portugal,0,0,0,0,2,9,11,18.181818181818183,39.399872,-8.224454
1974,Serbia,0,0,0,0,3,15,18,16.666666666666664,44.016521,21.005859
1974,South Korea,0,0,0,0,4,5,9,44.44444444444444,35.907757,127.766922
1974,Spain,0,0,0,0,167,157,324,51.54320987654321,40.463667,-3.74922
1974,Sri Lanka,0,0,0,0,1,3,4,25,7.873054,80.771797
1974,Switzerland,0,0,0,0,10,11,21,47.61904761904761,46.818188,8.227512
1974,Turkey,0,0,0,0,2,10,12,16.666666666666664,38.963745,35.243322
1974,Vatican City,0,0,0,0,74,81,155,47.74193548387097,41.902916,12.453389
1974,Venezuela,0,0,0,0,5,13,18,27.77777777777778,6.42375,-66.58973
1974,Vietnam,0,0,0,0,6,8,14,42.857142857142854,14.058324,108.277199
1974,Zimbabwe,0,0,0,0,7,18,25,28.000000000000004,-19.015438,29.154857
1975,Austria,0,0,0,0,29,38,67,43.28358208955223,47.516231,14.550072
1975,Belgium,0,0,0,0,13,20,33,39.39393939393939,50.503887,4.469936
1975,Bolivia,0,0,0,0,7,18,25,28.000000000000004,-16.290154,-63.588653
1975,Brazil,0,0,0,0,44,68,112,39.285714285714285,-14.235004,-51.92528
1975,Bulgaria,0,0,0,0,2,6,8,25,42.733883,25.48583
1975,Canada,0,0,0,0,8,16,24,33.33333333333333,56.130366,-106.346771
1975,Chile,0,0,0,0,98,87,185,52.972972972972975,-35.675147,-71.542969
1975,Colombia,0,0,0,0,35,43,78,44.871794871794876,4.570868,-74.297333
1975,Denmark,0,0,0,0,3,9,12,25,56.26392,9.501785
1975,Egypt,0,0,0,0,30,32,62,48.38709677419355,26.820553,30.802498
1975,Finland,0,0,0,0,2,8,10,20,61.92411,25.748151
1975,France,0,0,0,0,133,133,266,50,46.227638,2.213749
1975,Greece,0,0,0,0,3,2,5,60,39.074208,21.824312
1975,Hungary,0,0,0,0,42,42,84,50,47.162494,19.503304
1975,India,0,0,0,0,79,89,168,47.023809523809526,20.593684,78.96288
1975,Indonesia,0,0,0,0,5,3,8,62.5,-0.789275,113.921327
1975,Iran,0,0,0,0,3,5,8,37.5,32.427908,53.688046
1975,Ireland,0,0,0,0,2,5,7,28.57142857142857,53.41291,-8.24389
1975,Japan,0,0,0,0,27,76,103,26.21359223300971,36.204824,138.252924
1975,Monaco,0,0,0,0,5,3,8,62.5,43.750298,7.412841
1975,Pakistan,0,0,0,0,31,30,61,50.81967213114754,30.375321,69.345116
1975,Paraguay,0,0,0,0,21,23,44,47.72727272727273,-23.442503,-58.443832
1975,Peru,0,0,0,0,2,6,8,25,-9.189967,-75.015152
1975,Philippines,0,0,0,0,3,6,9,33.33333333333333,12.879721,121.774017
1975,Poland,0,0,0,0,45,36,81,55.55555555555556,51.919438,19.145136
1975,Portugal,0,0,0,0,5,3,8,62.5,39.399872,-8.224454
1975,Russia,0,0,0,0,33,34,67,49.25373134328358,61.52401,105.318756
1975,Serbia,0,0,0,0,21,26,47,44.680851063829785,44.016521,21.005859
1975,South Africa,0,0,0,0,147,187,334,44.01197604790419,-30.559482,22.937506
1975,South Korea,0,0,0,0,2,2,4,50,35.907757,127.766922
1975,Switzerland,0,0,0,0,5,13,18,27.77777777777778,46.818188,8.227512
1975,Turkey,0,0,0,0,3,18,21,14.285714285714285,38.963745,35.243322
1975,United Kingdom,0,0,0,0,196,237,433,45.26558891454965,55.378051,-3.435973
1975,Uruguay,0,0,0,0,2,2,4,50,-32.522779,-55.765835
1975,Venezuela,0,0,0,0,5,26,31,16.129032258064516,6.42375,-66.58973
1975,Zimbabwe,0,0,0,0,6,14,20,30,-19.015438,29.154857
1976,Austria,0,0,0,0,32,38,70,45.714285714285715,47.516231,14.550072
1976,Belgium,0,0,0,0,5,12,17,29.411764705882355,50.503887,4.469936
1976,Bolivia,0,0,0,0,12,22,34,35.294117647058826,-16.290154,-63.588653
1976,Brazil,0,0,0,0,36,44,80,45,-14.235004,-51.92528
1976,Bulgaria,0,0,0,0,2,2,4,50,42.733883,25.48583
1976,Canada,0,0,0,0,7,9,16,43.75,56.130366,-106.346771
1976,Colombia,0,0,0,0,31,46,77,40.25974025974026,4.570868,-74.297333
1976,Croatia,0,0,0,0,56,42,98,57.14285714285714,45.1,15.2
1976,Denmark,0,0,0,0,4,8,12,33.33333333333333,56.26392,9.501785
1976,Ecuador,0,0,0,0,3,5,8,37.5,-1.831239,-78.183406
1976,Egypt,0,0,0,0,20,32,52,38.46153846153847,26.820553,30.802498
1976,Finland,0,0,0,0,5,6,11,45.45454545454545,61.92411,25.748151
1976,France,0,0,0,0,99,132,231,42.857142857142854,46.227638,2.213749
1976,Germany,0,0,0,0,100,139,239,41.84100418410041,51.165691,10.451526
1976,Greece,0,0,0,0,3,5,8,37.5,39.074208,21.824312
1976,Hungary,0,0,0,0,56,38,94,59.57446808510638,47.162494,19.503304
1976,Indonesia,0,0,0,0,3,4,7,42.857142857142854,-0.789275,113.921327
1976,Iran,0,0,0,0,6,10,16,37.5,32.427908,53.688046
1976,Ireland,0,0,0,0,3,4,7,42.857142857142854,53.41291,-8.24389
1976,Israel,0,0,0,0,4,3,7,57.14285714285714,31.046051,34.851612
1976,Japan,0,0,0,0,31,40,71,43.66197183098591,36.204824,138.252924
1976,Malaysia,0,0,0,0,1,3,4,25,4.210484,101.975766
1976,Monaco,0,0,0,0,3,7,10,30,43.750298,7.412841
1976,Netherlands,0,0,0,0,40,43,83,48.19277108433735,52.132633,5.291266
1976,Pakistan,0,0,0,0,28,19,47,59.57446808510638,30.375321,69.345116
1976,Paraguay,0,0,0,0,46,32,78,58.97435897435898,-23.442503,-58.443832
1976,Peru,0,0,0,0,1,3,4,25,-9.189967,-75.015152
1976,Philippines,0,0,0,0,3,2,5,60,12.879721,121.774017
1976,Portugal,0,0,0,0,1,3,4,25,39.399872,-8.224454
1976,Russia,0,0,0,0,27,19,46,58.69565217391305,61.52401,105.318756
1976,Serbia,0,0,0,0,5,16,21,23.809523809523807,44.016521,21.005859
1976,South Korea,0,0,0,0,2,2,4,50,35.907757,127.766922
1976,Switzerland,0,0,0,0,7,17,24,29.166666666666668,46.818188,8.227512
1976,Thailand,0,0,0,0,3,5,8,37.5,15.870032,100.992541
1976,United Kingdom,0,0,0,0,151,183,334,45.209580838323355,55.378051,-3.435973
1976,Uruguay,0,0,0,0,2,2,4,50,-32.522779,-55.765835
1976,Venezuela,0,0,0,0,15,25,40,37.5,6.42375,-66.58973
1977,Algeria,0,0,0,0,1,3,4,25,28.033886,1.659626
1977,Austria,0,0,0,0,24,31,55,43.63636363636363,47.516231,14.550072
1977,Belgium,0,0,0,0,5,9,14,35.714285714285715,50.503887,4.469936
1977,Bolivia,0,0,0,0,9,18,27,33.33333333333333,-16.290154,-63.588653
1977,Brazil,0,0,0,0,9,23,32,28.125,-14.235004,-51.92528
1977,Canada,0,0,0,0,4,14,18,22.22222222222222,56.130366,-106.346771
1977,Chile,0,0,0,0,131,104,235,55.74468085106383,-35.675147,-71.542969
1977,Colombia,0,0,0,0,25,42,67,37.3134328358209,4.570868,-74.297333
1977,Croatia,0,0,0,0,47,37,84,55.952380952380956,45.1,15.2
1977,Denmark,0,0,0,0,2,6,8,25,56.26392,9.501785
1977,Ecuador,0,0,0,0,9,16,25,36,-1.831239,-78.183406
1977,Egypt,0,0,0,0,18,29,47,38.297872340425535,26.820553,30.802498
1977,Greece,0,0,0,0,2,8,10,20,39.074208,21.824312
1977,Hungary,0,0,0,0,41,29,70,58.57142857142858,47.162494,19.503304
1977,India,0,0,0,0,50,79,129,38.759689922480625,20.593684,78.96288
1977,Iran,0,0,0,0,5,9,14,35.714285714285715,32.427908,53.688046
1977,Ireland,0,0,0,0,2,5,7,28.57142857142857,53.41291,-8.24389
1977,Japan,0,0,0,0,15,19,34,44.11764705882353,36.204824,138.252924
1977,Monaco,0,0,0,0,4,4,8,50,43.750298,7.412841
1977,Morocco,0,0,0,0,7,2,9,77.77777777777779,31.791702,-7.09262
1977,Netherlands,0,0,0,0,26,27,53,49.056603773584904,52.132633,5.291266
1977,New Zealand,0,0,0,0,66,88,154,42.857142857142854,-40.900557,174.885971
1977,Norway,0,0,0,0,1,4,5,20,60.472024,8.468946
1977,Pakistan,0,0,0,0,12,9,21,57.14285714285714,30.375321,69.345116
1977,Paraguay,0,0,0,0,42,32,74,56.75675675675676,-23.442503,-58.443832
1977,Peru,0,0,0,0,1,5,6,16.666666666666664,-9.189967,-75.015152
1977,Philippines,0,0,0,0,5,5,10,50,12.879721,121.774017
1977,Portugal,0,0,0,0,1,4,5,20,39.399872,-8.224454
1977,Russia,0,0,0,0,9,11,20,45,61.52401,105.318756
1977,Serbia,0,0,0,0,15,21,36,41.66666666666667,44.016521,21.005859
1977,South Africa,0,0,0,0,180,225,405,44.44444444444444,-30.559482,22.937506
1977,South Korea,0,0,0,0,3,5,8,37.5,35.907757,127.766922
1977,Switzerland,0,0,0,0,12,18,30,40,46.818188,8.227512
1977,Uruguay,0,0,0,0,5,5,10,50,-32.522779,-55.765835
1977,Venezuela,0,0,0,0,6,19,25,24,6.42375,-66.58973
1978,Belgium,0,0,0,0,6,6,12,50,50.503887,4.469936
1978,Bolivia,0,0,0,0,4,15,19,21.052631578947366,-16.290154,-63.588653
1978,Brazil,0,0,0,0,20,26,46,43.47826086956522,-14.235004,-51.92528
1978,Canada,0,0,0,0,10,22,32,31.25,56.130366,-106.346771
1978,Chile,0,0,0,0,89,108,197,45.17766497461929,-35.675147,-71.542969
1978,Colombia,0,0,0,0,25,36,61,40.98360655737705,4.570868,-74.297333
1978,Croatia,0,0,0,0,40,37,77,51.94805194805194,45.1,15.2
1978,Ecuador,0,0,0,0,16,20,36,44.44444444444444,-1.831239,-78.183406
1978,Egypt,0,0,0,0,16,23,39,41.02564102564102,26.820553,30.802498
1978,Finland,0,0,0,0,5,3,8,62.5,61.92411,25.748151
1978,Indonesia,0,0,0,0,4,3,7,57.14285714285714,-0.789275,113.921327
1978,Iran,0,0,0,0,7,6,13,53.84615384615385,32.427908,53.688046
1978,Ireland,0,0,0,0,2,10,12,16.666666666666664,53.41291,-8.24389
1978,Japan,0,0,0,0,17,49,66,25.757575757575758,36.204824,138.252924
1978,Monaco,0,0,0,0,1,8,9,11.11111111111111,43.750298,7.412841
1978,Netherlands,0,0,0,0,36,50,86,41.86046511627907,52.132633,5.291266
1978,New Zealand,0,0,0,0,53,67,120,44.166666666666664,-40.900557,174.885971
1978,Norway,0,0,0,0,1,3,4,25,60.472024,8.468946
1978,Pakistan,0,0,0,0,4,4,8,50,30.375321,69.345116
1978,Peru,0,0,0,0,4,5,9,44.44444444444444,-9.189967,-75.015152
1978,Russia,0,0,0,0,3,3,6,50,61.52401,105.318756
1978,Serbia,0,0,0,0,4,5,9,44.44444444444444,44.016521,21.005859
1978,South Korea,0,0,0,0,1,3,4,25,35.907757,127.766922
1978,Switzerland,0,0,0,0,27,34,61,44.26229508196721,46.818188,8.227512
1978,United Kingdom,0,0,0,0,148,192,340,43.529411764705884,55.378051,-3.435973
1978,Uruguay,0,0,0,0,4,6,10,40,-32.522779,-55.765835
1978,Venezuela,0,0,0,0,9,11,20,45,6.42375,-66.58973
1978,Zimbabwe,0,0,0,0,2,2,4,50,-19.015438,29.154857
1979,Algeria,0,0,0,0,1,3,4,25,28.033886,1.659626
1979,Belgium,0,0,0,0,8,10,18,44.44444444444444,50.503887,4.469936
1979,Bolivia,0,0,0,0,4,9,13,30.76923076923077,-16.290154,-63.588653
1979,Brazil,0,0,0,0,43,61,104,41.34615384615385,-14.235004,-51.92528
1979,Bulgaria,0,0,0,0,2,2,4,50,42.733883,25.48583
1979,Canada,0,0,0,0,7,21,28,25,56.130366,-106.346771
1979,Colombia,0,0,0,0,18,32,50,36,4.570868,-74.297333
1979,Croatia,0,0,0,0,23,28,51,45.09803921568628,45.1,15.2
1979,Denmark,0,0,0,0,1,8,9,11.11111111111111,56.26392,9.501785
1979,Ecuador,0,0,0,0,21,25,46,45.65217391304348,-1.831239,-78.183406
1979,Egypt,0,0,0,0,8,22,30,26.666666666666668,26.820553,30.802498
1979,Finland,0,0,0,0,10,11,21,47.61904761904761,61.92411,25.748151
1979,Greece,0,0,0,0,1,5,6,16.666666666666664,39.074208,21.824312
1979,India,0,0,0,0,61,80,141,43.262411347517734,20.593684,78.96288
1979,Ireland,0,0,0,0,6,12,18,33.33333333333333,53.41291,-8.24389
1979,Israel,0,0,0,0,8,12,20,40,31.046051,34.851612
1979,Japan,0,0,0,0,13,29,42,30.952380952380953,36.204824,138.252924
1979,Luxembourg,0,0,0,0,1,3,4,25,49.815273,6.129583
1979,Mexico,0,0,0,0,46,42,88,52.27272727272727,23.634501,-102.552784
1979,Monaco,0,0,0,0,1,5,6,16.666666666666664,43.750298,7.412841
1979,Morocco,0,0,0,0,4,4,8,50,31.791702,-7.09262
1979,Netherlands,0,0,0,0,35,40,75,46.666666666666664,52.132633,5.291266
1979,New Zealand,0,0,0,0,32,67,99,32.323232323232325,-40.900557,174.885971
1979,Nigeria,0,0,0,0,2,3,5,40,9.081999,8.675277
1979,Norway,0,0,0,0,3,1,4,75,60.472024,8.468946
1979,Pakistan,0,0,0,0,1,3,4,25,30.375321,69.345116
1979,Romania,0,0,0,0,37,32,69,53.62318840579711,45.943161,24.96676
1979,Russia,0,0,0,0,4,3,7,57.14285714285714,61.52401,105.318756
1979,Serbia,0,0,0,0,3,6,9,33.33333333333333,44.016521,21.005859
1979,South Korea,0,0,0,0,10,2,12,83.33333333333334,35.907757,127.766922
1979,Switzerland,0,0,0,0,35,32,67,52.23880597014925,46.818188,8.227512
1979,Taiwan,0,0,0,0,3,5,8,37.5,23.69781,120.960515
1979,Thailand,0,0,0,0,1,3,4,25,15.870032,100.992541
1979,Turkey,0,0,0,0,4,4,8,50,38.963745,35.243322
1979,United Kingdom,0,0,0,0,102,127,229,44.54148471615721,55.378051,-3.435973
1979,Uruguay,0,0,0,0,7,16,23,30.434782608695656,-32.522779,-55.765835
1979,Venezuela,0,0,0,0,7,29,36,19.444444444444446,6.42375,-66.58973
1979,Zimbabwe,0,0,0,0,4,14,18,22.22222222222222,-19.015438,29.154857
1980,Austria,0,0,0,0,42,60,102,41.17647058823529,47.516231,14.550072
1980,Belgium,0,0,0,0,5,13,18,27.77777777777778,50.503887,4.469936
1980,Bolivia,0,0,0,0,26,19,45,57.77777777777777,-16.290154,-63.588653
1980,Brazil,0,0,0,0,45,64,109,41.284403669724774,-14.235004,-51.92528
1980,Bulgaria,0,0,0,0,1,4,5,20,42.733883,25.48583
1980,Canada,0,0,0,0,7,19,26,26.923076923076923,56.130366,-106.346771
1980,Chile,0,0,0,0,65,88,153,42.48366013071895,-35.675147,-71.542969
1980,China,0,0,0,0,1,2,3,33.33333333333333,35.86166,104.195397
1980,Colombia,0,0,0,0,11,32,43,25.581395348837212,4.570868,-74.297333
1980,Croatia,0,0,0,0,25,29,54,46.2962962962963,45.1,15.2
1980,Ecuador,0,0,0,0,51,41,92,55.434782608695656,-1.831239,-78.183406
1980,Egypt,0,0,0,0,3,11,14,21.428571428571427,26.820553,30.802498
1980,Finland,0,0,0,0,12,17,29,41.37931034482759,61.92411,25.748151
1980,Ireland,0,0,0,0,4,13,17,23.52941176470588,53.41291,-8.24389
1980,Japan,0,0,0,0,5,15,20,25,36.204824,138.252924
1980,Netherlands,0,0,0,0,24,39,63,38.095238095238095,52.132633,5.291266
1980,New Zealand,0,0,0,0,64,80,144,44.44444444444444,-40.900557,174.885971
1980,Peru,0,0,0,0,6,8,14,42.857142857142854,-9.189967,-75.015152
1980,Romania,0,0,0,0,32,34,66,48.484848484848484,45.943161,24.96676
1980,Russia,0,0,0,0,9,2,11,81.81818181818183,61.52401,105.318756
1980,South Africa,0,0,0,0,80,133,213,37.558685446009385,-30.559482,22.937506
1980,Switzerland,0,0,0,0,50,47,97,51.546391752577314,46.818188,8.227512
1980,Thailand,0,0,0,0,1,2,3,33.33333333333333,15.870032,100.992541
1980,United Kingdom,0,0,0,0,64,121,185,34.5945945945946,55.378051,-3.435973
1980,Uruguay,0,0,0,0,8,8,16,50,-32.522779,-55.765835
1980,Zimbabwe,0,0,0,0,8,9,17,47.05882352941176,-19.015438,29.154857
1981,Austria,0,0,0,0,23,56,79,29.11392405063291,47.516231,14.550072
1981,Bahamas,0,0,0,0,1,1,2,50,25.03428,-77.39628
1981,Belgium,0,0,0,0,6,16,22,27.27272727272727,50.503887,4.469936
1981,Bulgaria,0,0,0,0,7,7,14,50,42.733883,25.48583
1981,Canada,0,0,0,0,2,8,10,20,56.130366,-106.346771
1981,Colombia,0,0,0,0,13,17,30,43.333333333333336,4.570868,-74.297333
1981,Croatia,0,0,0,0,21,30,51,41.17647058823529,45.1,15.2
1981,Denmark,0,0,0,0,6,2,8,75,56.26392,9.501785
1981,Egypt,0,0,0,0,8,12,20,40,26.820553,30.802498
1981,Finland,0,0,0,0,9,12,21,42.857142857142854,61.92411,25.748151
1981,Germany,0,0,0,0,91,128,219,41.55251141552511,51.165691,10.451526
1981,Greece,0,0,0,0,1,6,7,14.285714285714285,39.074208,21.824312
1981,India,0,0,0,0,58,65,123,47.15447154471545,20.593684,78.96288
1981,Indonesia,0,0,0,0,8,2,10,80,-0.789275,113.921327
1981,Iran,0,0,0,0,1,1,2,50,32.427908,53.688046
1981,Ireland,0,0,0,0,4,11,15,26.666666666666668,53.41291,-8.24389
1981,Israel,0,0,0,0,46,29,75,61.33333333333333,31.046051,34.851612
1981,Japan,0,0,0,0,12,41,53,22.641509433962266,36.204824,138.252924
1981,Mexico,0,0,0,0,29,30,59,49.152542372881356,23.634501,-102.552784
1981,Monaco,0,0,0,0,5,6,11,45.45454545454545,43.750298,7.412841
1981,Morocco,0,0,0,0,1,2,3,33.33333333333333,31.791702,-7.09262
1981,Netherlands,0,0,0,0,16,30,46,34.78260869565217,52.132633,5.291266
1981,Nigeria,0,0,0,0,3,3,6,50,9.081999,8.675277
1981,Norway,0,0,0,0,2,2,4,50,60.472024,8.468946
1981,Peru,0,0,0,0,7,23,30,23.333333333333332,-9.189967,-75.015152
1981,Philippines,0,0,0,0,3,6,9,33.33333333333333,12.879721,121.774017
1981,Romania,0,0,0,0,33,34,67,49.25373134328358,45.943161,24.96676
1981,Serbia,0,0,0,0,1,1,2,50,44.016521,21.005859
1981,South Africa,0,0,0,0,51,92,143,35.66433566433567,-30.559482,22.937506
1981,South Korea,0,0,0,0,1,5,6,16.666666666666664,35.907757,127.766922
1981,Switzerland,0,0,0,0,49,52,101,48.51485148514851,46.818188,8.227512
1981,Thailand,0,0,0,0,4,6,10,40,15.870032,100.992541
1981,United Kingdom,0,0,0,0,42,74,116,36.206896551724135,55.378051,-3.435973
1981,Uruguay,0,0,0,0,40,36,76,52.63157894736842,-32.522779,-55.765835
1981,Venezuela,0,0,0,0,3,4,7,42.857142857142854,6.42375,-66.58973
1981,Zimbabwe,0,0,0,0,5,7,12,41.66666666666667,-19.015438,29.154857
1982,Austria,0,0,0,0,23,43,66,34.84848484848485,47.516231,14.550072
1982,Belgium,0,0,0,0,6,10,16,37.5,50.503887,4.469936
1982,Bolivia,0,0,0,0,22,28,50,44,-16.290154,-63.588653
1982,Brazil,0,0,0,0,82,115,197,41.62436548223351,-14.235004,-51.92528
1982,Bulgaria,0,0,0,0,1,3,4,25,42.733883,25.48583
1982,Canada,0,0,0,0,16,16,32,50,56.130366,-106.346771
1982,Colombia,0,0,0,0,10,13,23,43.47826086956522,4.570868,-74.297333
1982,Croatia,0,0,0,0,20,28,48,41.66666666666667,45.1,15.2
1982,Denmark,0,0,0,0,11,3,14,78.57142857142857,56.26392,9.501785
1982,Egypt,0,0,0,0,6,6,12,50,26.820553,30.802498
1982,Finland,0,0,0,0,13,23,36,36.11111111111111,61.92411,25.748151
1982,Germany,0,0,0,0,82,154,236,34.74576271186441,51.165691,10.451526
1982,Greece,0,0,0,0,6,2,8,75,39.074208,21.824312
1982,India,0,0,0,0,43,54,97,44.329896907216494,20.593684,78.96288
1982,Indonesia,0,0,0,0,9,3,12,75,-0.789275,113.921327
1982,Ireland,0,0,0,0,7,6,13,53.84615384615385,53.41291,-8.24389
1982,Israel,0,0,0,0,33,25,58,56.896551724137936,31.046051,34.851612
1982,Italy,0,0,0,0,83,115,198,41.91919191919192,41.87194,12.56738
1982,Japan,0,0,0,0,13,19,32,40.625,36.204824,138.252924
1982,Malaysia,0,0,0,0,1,3,4,25,4.210484,101.975766
1982,Monaco,0,0,0,0,1,3,4,25,43.750298,7.412841
1982,Morocco,0,0,0,0,2,6,8,25,31.791702,-7.09262
1982,New Zealand,0,0,0,0,63,73,136,46.32352941176471,-40.900557,174.885971
1982,Nigeria,0,0,0,0,13,16,29,44.827586206896555,9.081999,8.675277
1982,Paraguay,0,0,0,0,43,44,87,49.42528735632184,-23.442503,-58.443832
1982,Peru,0,0,0,0,37,27,64,57.8125,-9.189967,-75.015152
1982,Philippines,0,0,0,0,2,6,8,25,12.879721,121.774017
1982,Portugal,0,0,0,0,3,4,7,42.857142857142854,39.399872,-8.224454
1982,Romania,0,0,0,0,24,35,59,40.67796610169492,45.943161,24.96676
1982,Russia,0,0,0,0,2,4,6,33.33333333333333,61.52401,105.318756
1982,South Africa,0,0,0,0,60,99,159,37.735849056603776,-30.559482,22.937506
1982,South Korea,0,0,0,0,5,3,8,62.5,35.907757,127.766922
1982,Sri Lanka,0,0,0,0,1,2,3,33.33333333333333,7.873054,80.771797
1982,Switzerland,0,0,0,0,49,55,104,47.11538461538461,46.818188,8.227512
1982,Taiwan,0,0,0,0,1,4,5,20,23.69781,120.960515
1982,Thailand,0,0,0,0,2,6,8,25,15.870032,100.992541
1982,United Kingdom,0,0,0,0,59,76,135,43.7037037037037,55.378051,-3.435973
1982,Uruguay,0,0,0,0,27,42,69,39.130434782608695,-32.522779,-55.765835
1982,Zimbabwe,0,0,0,0,3,14,17,17.647058823529413,-19.015438,29.154857
1983,Algeria,0,0,0,0,1,3,4,25,28.033886,1.659626
1983,Austria,0,0,0,0,18,23,41,43.90243902439025,47.516231,14.550072
1983,Belgium,0,0,0,0,34,33,67,50.74626865671642,50.503887,4.469936
1983,Bolivia,0,0,0,0,19,20,39,48.717948717948715,-16.290154,-63.588653
1983,Brazil,0,0,0,0,73,125,198,36.868686868686865,-14.235004,-51.92528
1983,Bulgaria,0,0,0,0,5,7,12,41.66666666666667,42.733883,25.48583
1983,Canada,0,0,0,0,15,18,33,45.45454545454545,56.130366,-106.346771
1983,China,0,0,0,0,1,3,4,25,35.86166,104.195397
1983,Croatia,0,0,0,0,14,13,27,51.85185185185185,45.1,15.2
1983,Denmark,0,0,0,0,6,5,11,54.54545454545454,56.26392,9.501785
1983,Egypt,0,0,0,0,1,3,4,25,26.820553,30.802498
1983,Finland,0,0,0,0,3,3,6,50,61.92411,25.748151
1983,Germany,0,0,0,0,86,106,192,44.79166666666667,51.165691,10.451526
1983,Greece,0,0,0,0,1,5,6,16.666666666666664,39.074208,21.824312
1983,Hungary,0,0,0,0,27,35,62,43.54838709677419,47.162494,19.503304
1983,India,0,0,0,0,39,47,86,45.348837209302324,20.593684,78.96288
1983,Indonesia,0,0,0,0,1,7,8,12.5,-0.789275,113.921327
1983,Iran,0,0,0,0,2,1,3,66.66666666666666,32.427908,53.688046
1983,Ireland,0,0,0,0,1,8,9,11.11111111111111,53.41291,-8.24389
1983,Israel,0,0,0,0,27,27,54,50,31.046051,34.851612
1983,Italy,0,0,0,0,68,90,158,43.037974683544306,41.87194,12.56738
1983,Japan,0,0,0,0,9,15,24,37.5,36.204824,138.252924
1983,Luxembourg,0,0,0,0,1,3,4,25,49.815273,6.129583
1983,Mexico,0,0,0,0,13,12,25,52,23.634501,-102.552784
1983,Monaco,0,0,0,0,4,5,9,44.44444444444444,43.750298,7.412841
1983,Netherlands,0,0,0,0,15,23,38,39.473684210526315,52.132633,5.291266
1983,New Zealand,0,0,0,0,52,59,111,46.846846846846844,-40.900557,174.885971
1983,Nigeria,0,0,0,0,19,20,39,48.717948717948715,9.081999,8.675277
1983,Norway,0,0,0,0,1,5,6,16.666666666666664,60.472024,8.468946
1983,Paraguay,0,0,0,0,32,36,68,47.05882352941176,-23.442503,-58.443832
1983,Philippines,0,0,0,0,5,3,8,62.5,12.879721,121.774017
1983,Poland,0,0,0,0,27,27,54,50,51.919438,19.145136
1983,Portugal,0,0,0,0,1,4,5,20,39.399872,-8.224454
1983,Romania,0,0,0,0,23,30,53,43.39622641509434,45.943161,24.96676
1983,Russia,0,0,0,0,1,5,6,16.666666666666664,61.52401,105.318756
1983,Slovakia,0,0,0,0,12,6,18,66.66666666666666,48.669026,19.699024
1983,South Africa,0,0,0,0,42,88,130,32.30769230769231,-30.559482,22.937506
1983,South Korea,0,0,0,0,4,4,8,50,35.907757,127.766922
1983,Sri Lanka,0,0,0,0,3,5,8,37.5,7.873054,80.771797
1983,Taiwan,0,0,0,0,2,3,5,40,23.69781,120.960515
1983,Thailand,0,0,0,0,2,6,8,25,15.870032,100.992541
1983,United Kingdom,0,0,0,0,38,53,91,41.75824175824176,55.378051,-3.435973
1983,Uruguay,0,0,0,0,27,21,48,56.25,-32.522779,-55.765835
1983,Venezuela,0,0,0,0,1,4,5,20,6.42375,-66.58973
1983,Zimbabwe,0,0,0,0,5,4,9,55.55555555555556,-19.015438,29.154857
1984,Argentina,0,0,0,0,88,90,178,49.43820224719101,-38.416097,-63.616672
1984,Austria,0,0,0,0,13,10,23,56.52173913043478,47.516231,14.550072
1984,Barbados,0,0,0,0,1,1,2,50,13.193887,-59.543198
1984,Belgium,0,0,0,0,47,33,80,58.75,50.503887,4.469936
1984,Bolivia,0,0,0,0,3,7,10,30,-16.290154,-63.588653
1984,Brazil,0,0,0,0,31,63,94,32.97872340425532,-14.235004,-51.92528
1984,Bulgaria,0,0,0,0,2,2,4,50,42.733883,25.48583
1984,Canada,0,0,0,0,9,25,34,26.47058823529412,56.130366,-106.346771
1984,Chile,0,0,0,0,38,41,79,48.10126582278481,-35.675147,-71.542969
1984,China,0,0,0,0,7,6,13,53.84615384615385,35.86166,104.195397
1984,Croatia,0,0,0,0,15,24,39,38.46153846153847,45.1,15.2
1984,Denmark,0,0,0,0,5,10,15,33.33333333333333,56.26392,9.501785
1984,Egypt,0,0,0,0,5,3,8,62.5,26.820553,30.802498
1984,Finland,0,0,0,0,8,6,14,57.14285714285714,61.92411,25.748151
1984,Germany,0,0,0,0,96,129,225,42.66666666666667,51.165691,10.451526
1984,Greece,0,0,0,0,1,5,6,16.666666666666664,39.074208,21.824312
1984,Hungary,0,0,0,0,37,42,79,46.835443037974684,47.162494,19.503304
1984,India,0,0,0,0,56,44,100,56.00000000000001,20.593684,78.96288
1984,Ireland,0,0,0,0,3,4,7,42.857142857142854,53.41291,-8.24389
1984,Israel,0,0,0,0,45,45,90,50,31.046051,34.851612
1984,Japan,0,0,0,0,11,20,31,35.483870967741936,36.204824,138.252924
1984,Mexico,0,0,0,0,13,9,22,59.09090909090909,23.634501,-102.552784
1984,Monaco,0,0,0,0,3,5,8,37.5,43.750298,7.412841
1984,Morocco,0,0,0,0,1,5,6,16.666666666666664,31.791702,-7.09262
1984,Netherlands,0,0,0,0,17,20,37,45.94594594594595,52.132633,5.291266
1984,New Zealand,0,0,0,0,35,58,93,37.634408602150536,-40.900557,174.885971
1984,Nigeria,0,0,0,0,9,14,23,39.130434782608695,9.081999,8.675277
1984,Norway,0,0,0,0,3,5,8,37.5,60.472024,8.468946
1984,Pakistan,0,0,0,0,13,3,16,81.25,30.375321,69.345116
1984,Paraguay,0,0,0,0,32,34,66,48.484848484848484,-23.442503,-58.443832
1984,Peru,0,0,0,0,19,24,43,44.18604651162791,-9.189967,-75.015152
1984,Philippines,0,0,0,0,4,5,9,44.44444444444444,12.879721,121.774017
1984,Poland,0,0,0,0,24,28,52,46.15384615384615,51.919438,19.145136
1984,Portugal,0,0,0,0,1,4,5,20,39.399872,-8.224454
1984,Romania,0,0,0,0,7,29,36,19.444444444444446,45.943161,24.96676
1984,Russia,0,0,0,0,9,3,12,75,61.52401,105.318756
1984,Senegal,0,0,0,0,2,6,8,25,14.497401,-14.452362
1984,Slovakia,0,0,0,0,23,23,46,50,48.669026,19.699024
1984,South Africa,0,0,0,0,45,63,108,41.66666666666667,-30.559482,22.937506
1984,Sri Lanka,0,0,0,0,1,3,4,25,7.873054,80.771797
1984,Switzerland,0,0,0,0,57,67,124,45.96774193548387,46.818188,8.227512
1984,Taiwan,0,0,0,0,2,2,4,50,23.69781,120.960515
1984,Thailand,0,0,0,0,4,4,8,50,15.870032,100.992541
1984,Tunisia,0,0,0,0,2,2,4,50,33.886917,9.537499
1984,United Kingdom,0,0,0,0,37,72,109,33.94495412844037,55.378051,-3.435973
1984,Uruguay,0,0,0,0,20,19,39,51.28205128205128,-32.522779,-55.765835
1984,Zimbabwe,0,0,0,0,1,4,5,20,-19.015438,29.154857
1985,Algeria,0,0,0,0,1,3,4,25,28.033886,1.659626
1985,Australia,0,0,0,0,180,249,429,41.95804195804196,-25.274398,133.775136
1985,Austria,0,0,0,0,20,26,46,43.47826086956522,47.516231,14.550072
1985,Belgium,0,0,0,0,27,28,55,49.09090909090909,50.503887,4.469936
1985,Brazil,0,0,0,0,33,68,101,32.67326732673268,-14.235004,-51.92528
1985,Bulgaria,0,0,0,0,1,2,3,33.33333333333333,42.733883,25.48583
1985,Canada,0,0,0,0,18,27,45,40,56.130366,-106.346771
1985,Chile,0,0,0,0,21,34,55,38.18181818181819,-35.675147,-71.542969
1985,China,0,0,0,0,3,3,6,50,35.86166,104.195397
1985,Colombia,0,0,0,0,3,5,8,37.5,4.570868,-74.297333
1985,Croatia,0,0,0,0,23,33,56,41.07142857142857,45.1,15.2
1985,Cyprus,0,0,0,0,1,3,4,25,35.126413,33.429859
1985,Denmark,0,0,0,0,10,2,12,83.33333333333334,56.26392,9.501785
1985,Egypt,0,0,0,0,7,9,16,43.75,26.820553,30.802498
1985,Finland,0,0,0,0,1,5,6,16.666666666666664,61.92411,25.748151
1985,Greece,0,0,0,0,5,3,8,62.5,39.074208,21.824312
1985,Hungary,0,0,0,0,17,36,53,32.075471698113205,47.162494,19.503304
1985,India,0,0,0,0,42,49,91,46.15384615384615,20.593684,78.96288
1985,Iran,0,0,0,0,1,1,2,50,32.427908,53.688046
1985,Ireland,0,0,0,0,3,1,4,75,53.41291,-8.24389
1985,Israel,0,0,0,0,46,55,101,45.54455445544555,31.046051,34.851612
1985,Japan,0,0,0,0,3,27,30,10,36.204824,138.252924
1985,Mexico,0,0,0,0,18,14,32,56.25,23.634501,-102.552784
1985,Monaco,0,0,0,0,5,9,14,35.714285714285715,43.750298,7.412841
1985,Morocco,0,0,0,0,1,3,4,25,31.791702,-7.09262
1985,Netherlands,0,0,0,0,31,46,77,40.25974025974026,52.132633,5.291266
1985,Nigeria,0,0,0,0,10,15,25,40,9.081999,8.675277
1985,Norway,0,0,0,0,1,3,4,25,60.472024,8.468946
1985,Pakistan,0,0,0,0,1,3,4,25,30.375321,69.345116
1985,Paraguay,0,0,0,0,25,40,65,38.46153846153847,-23.442503,-58.443832
1985,Peru,0,0,0,0,19,21,40,47.5,-9.189967,-75.015152
1985,Philippines,0,0,0,0,7,5,12,58.333333333333336,12.879721,121.774017
1985,Poland,0,0,0,0,15,19,34,44.11764705882353,51.919438,19.145136
1985,Portugal,0,0,0,0,4,4,8,50,39.399872,-8.224454
1985,Romania,0,0,0,0,14,15,29,48.275862068965516,45.943161,24.96676
1985,Russia,0,0,0,0,6,9,15,40,61.52401,105.318756
1985,Senegal,0,0,0,0,1,3,4,25,14.497401,-14.452362
1985,South Africa,0,0,0,0,46,71,117,39.31623931623932,-30.559482,22.937506
1985,South Korea,0,0,0,0,11,3,14,78.57142857142857,35.907757,127.766922
1985,Spain,0,0,0,0,103,136,239,43.09623430962343,40.463667,-3.74922
1985,Switzerland,0,0,0,0,65,58,123,52.84552845528455,46.818188,8.227512
1985,Taiwan,0,0,0,0,4,4,8,50,23.69781,120.960515
1985,Thailand,0,0,0,0,1,3,4,25,15.870032,100.992541
1985,United Kingdom,0,0,0,0,52,74,126,41.269841269841265,55.378051,-3.435973
1985,Zimbabwe,0,0,0,0,3,7,10,30,-19.015438,29.154857
1986,Algeria,0,0,0,0,6,2,8,75,28.033886,1.659626
1986,Austria,0,0,0,0,41,35,76,53.94736842105263,47.516231,14.550072
1986,Belgium,0,0,0,0,30,35,65,46.15384615384615,50.503887,4.469936
1986,Brazil,0,0,0,0,36,64,100,36,-14.235004,-51.92528
1986,Bulgaria,0,0,0,0,7,5,12,58.333333333333336,42.733883,25.48583
1986,Canada,0,0,0,0,25,57,82,30.48780487804878,56.130366,-106.346771
1986,Chile,0,0,0,0,21,40,61,34.42622950819672,-35.675147,-71.542969
1986,China,0,0,0,0,3,3,6,50,35.86166,104.195397
1986,Croatia,0,0,0,0,18,34,52,34.61538461538461,45.1,15.2
1986,Denmark,0,0,0,0,3,7,10,30,56.26392,9.501785
1986,Egypt,0,0,0,0,5,5,10,50,26.820553,30.802498
1986,Finland,0,0,0,0,3,5,8,37.5,61.92411,25.748151
1986,Greece,0,0,0,0,5,6,11,45.45454545454545,39.074208,21.824312
1986,Hungary,0,0,0,0,6,6,12,50,47.162494,19.503304
1986,India,0,0,0,0,44,36,80,55.00000000000001,20.593684,78.96288
1986,Indonesia,0,0,0,0,3,4,7,42.857142857142854,-0.789275,113.921327
1986,Iran,0,0,0,0,5,4,9,55.55555555555556,32.427908,53.688046
1986,Ireland,0,0,0,0,1,2,3,33.33333333333333,53.41291,-8.24389
1986,Israel,0,0,0,0,40,39,79,50.63291139240506,31.046051,34.851612
1986,Japan,0,0,0,0,9,13,22,40.909090909090914,36.204824,138.252924
1986,Kenya,0,0,0,0,2,2,4,50,-0.023559,37.906193
1986,Luxembourg,0,0,0,0,2,2,4,50,49.815273,6.129583
1986,Malaysia,0,0,0,0,2,2,4,50,4.210484,101.975766
1986,Mexico,0,0,0,0,35,41,76,46.05263157894737,23.634501,-102.552784
1986,Monaco,0,0,0,0,2,2,4,50,43.750298,7.412841
1986,Morocco,0,0,0,0,3,5,8,37.5,31.791702,-7.09262
1986,Netherlands,0,0,0,0,28,37,65,43.07692307692308,52.132633,5.291266
1986,New Zealand,0,0,0,0,16,40,56,28.57142857142857,-40.900557,174.885971
1986,Nigeria,0,0,0,0,20,25,45,44.44444444444444,9.081999,8.675277
1986,Pakistan,0,0,0,0,4,4,8,50,30.375321,69.345116
1986,Paraguay,0,0,0,0,7,19,26,26.923076923076923,-23.442503,-58.443832
1986,Peru,0,0,0,0,51,51,102,50,-9.189967,-75.015152
1986,Philippines,0,0,0,0,1,3,4,25,12.879721,121.774017
1986,Poland,0,0,0,0,8,17,25,32,51.919438,19.145136
1986,Portugal,0,0,0,0,2,6,8,25,39.399872,-8.224454
1986,Romania,0,0,0,0,8,17,25,32,45.943161,24.96676
1986,Russia,0,0,0,0,15,17,32,46.875,61.52401,105.318756
1986,Senegal,0,0,0,0,1,3,4,25,14.497401,-14.452362
1986,South Africa,0,0,0,0,79,101,180,43.888888888888886,-30.559482,22.937506
1986,South Korea,0,0,0,0,10,2,12,83.33333333333334,35.907757,127.766922
1986,Sri Lanka,0,0,0,0,1,3,4,25,7.873054,80.771797
1986,Switzerland,0,0,0,0,63,69,132,47.72727272727273,46.818188,8.227512
1986,Taiwan,0,0,0,0,3,3,6,50,23.69781,120.960515
1986,Thailand,0,0,0,0,7,4,11,63.63636363636363,15.870032,100.992541
1986,Turkey,0,0,0,0,2,6,8,25,38.963745,35.243322
1986,United Kingdom,0,0,0,0,26,42,68,38.23529411764706,55.378051,-3.435973
1986,Uruguay,0,0,0,0,33,30,63,52.38095238095239,-32.522779,-55.765835
1986,Venezuela,0,0,0,0,1,3,4,25,6.42375,-66.58973
1986,Zimbabwe,0,0,0,0,9,3,12,75,-19.015438,29.154857
1987,Algeria,0,0,0,0,1,3,4,25,28.033886,1.659626
1987,Austria,0,0,0,0,56,55,111,50.45045045045045,47.516231,14.550072
1987,Bahamas,0,0,0,0,3,3,6,50,25.03428,-77.39628
1987,Belgium,0,0,0,0,13,27,40,32.5,50.503887,4.469936
1987,Bulgaria,0,0,0,0,4,4,8,50,42.733883,25.48583
1987,Canada,0,0,0,0,29,43,72,40.27777777777778,56.130366,-106.346771
1987,Chile,0,0,0,0,19,21,40,47.5,-35.675147,-71.542969
1987,China,0,0,0,0,9,7,16,56.25,35.86166,104.195397
1987,Colombia,0,0,0,0,1,6,7,14.285714285714285,4.570868,-74.297333
1987,Croatia,0,0,0,0,6,16,22,27.27272727272727,45.1,15.2
1987,Cuba,0,0,0,0,2,2,4,50,21.521757,-77.781167
1987,Czech Republic,0,0,0,0,96,103,199,48.24120603015075,49.817492,15.472962
1987,Denmark,0,0,0,0,9,7,16,56.25,56.26392,9.501785
1987,Egypt,0,0,0,0,2,2,4,50,26.820553,30.802498
1987,Finland,0,0,0,0,4,5,9,44.44444444444444,61.92411,25.748151
1987,Greece,0,0,0,0,5,5,10,50,39.074208,21.824312
1987,India,0,0,0,0,44,36,80,55.00000000000001,20.593684,78.96288
1987,Indonesia,0,0,0,0,1,3,4,25,-0.789275,113.921327
1987,Iran,0,0,0,0,5,7,12,41.66666666666667,32.427908,53.688046
1987,Ireland,0,0,0,0,1,4,5,20,53.41291,-8.24389
1987,Jamaica,0,0,0,0,2,2,4,50,18.109581,-77.297508
1987,Japan,0,0,0,0,8,13,21,38.095238095238095,36.204824,138.252924
1987,Malta,0,0,0,0,1,3,4,25,35.937496,14.375416
1987,Mexico,0,0,0,0,15,33,48,31.25,23.634501,-102.552784
1987,Monaco,0,0,0,0,2,2,4,50,43.750298,7.412841
1987,Morocco,0,0,0,0,2,2,4,50,31.791702,-7.09262
1987,Netherlands,0,0,0,0,39,43,82,47.5609756097561,52.132633,5.291266
1987,New Zealand,0,0,0,0,50,34,84,59.523809523809526,-40.900557,174.885971
1987,Nigeria,0,0,0,0,26,35,61,42.62295081967213,9.081999,8.675277
1987,Norway,0,0,0,0,2,2,4,50,60.472024,8.468946
1987,Pakistan,0,0,0,0,6,2,8,75,30.375321,69.345116
1987,Paraguay,0,0,0,0,12,12,24,50,-23.442503,-58.443832
1987,Peru,0,0,0,0,41,48,89,46.06741573033708,-9.189967,-75.015152
1987,Philippines,0,0,0,0,5,3,8,62.5,12.879721,121.774017
1987,Poland,0,0,0,0,3,10,13,23.076923076923077,51.919438,19.145136
1987,Portugal,0,0,0,0,7,5,12,58.333333333333336,39.399872,-8.224454
1987,Romania,0,0,0,0,6,6,12,50,45.943161,24.96676
1987,Russia,0,0,0,0,37,26,63,58.730158730158735,61.52401,105.318756
1987,Senegal,0,0,0,0,9,11,20,45,14.497401,-14.452362
1987,South Africa,0,0,0,0,73,108,181,40.331491712707184,-30.559482,22.937506
1987,South Korea,0,0,0,0,4,11,15,26.666666666666668,35.907757,127.766922
1987,Switzerland,0,0,0,0,71,54,125,56.8,46.818188,8.227512
1987,Taiwan,0,0,0,0,4,4,8,50,23.69781,120.960515
1987,Thailand,0,0,0,0,3,5,8,37.5,15.870032,100.992541
1987,Turkey,0,0,0,0,5,3,8,62.5,38.963745,35.243322
1987,Ukraine,0,0,0,0,1,1,2,50,48.379433,31.16558
1987,United Kingdom,0,0,0,0,28,49,77,36.36363636363637,55.378051,-3.435973
1987,Uruguay,0,0,0,0,24,25,49,48.97959183673469,-32.522779,-55.765835
1987,Venezuela,0,0,0,0,1,3,4,25,6.42375,-66.58973
1987,Zimbabwe,0,0,0,0,8,4,12,66.66666666666666,-19.015438,29.154857
1988,Algeria,0,0,0,0,1,3,4,25,28.033886,1.659626
1988,Bahamas,0,0,0,0,10,17,27,37.03703703703704,25.03428,-77.39628
1988,Bangladesh,0,0,0,0,1,3,4,25,23.684994,90.356331
1988,Belgium,0,0,0,0,27,44,71,38.028169014084504,50.503887,4.469936
1988,Bolivia,0,0,0,0,1,3,4,25,-16.290154,-63.588653
1988,Brazil,0,0,0,0,43,76,119,36.134453781512605,-14.235004,-51.92528
1988,Bulgaria,0,0,0,0,1,7,8,12.5,42.733883,25.48583
1988,Canada,0,0,0,0,47,69,116,40.51724137931034,56.130366,-106.346771
1988,Chile,0,0,0,0,17,34,51,33.33333333333333,-35.675147,-71.542969
1988,China,0,0,0,0,1,3,4,25,35.86166,104.195397
1988,Colombia,0,0,0,0,1,3,4,25,4.570868,-74.297333
1988,Croatia,0,0,0,0,22,30,52,42.30769230769231,45.1,15.2
1988,Cuba,0,0,0,0,3,6,9,33.33333333333333,21.521757,-77.781167
1988,Czech Republic,0,0,0,0,79,103,182,43.40659340659341,49.817492,15.472962
1988,Denmark,0,0,0,0,3,7,10,30,56.26392,9.501785
1988,Ecuador,0,0,0,0,42,27,69,60.86956521739131,-1.831239,-78.183406
1988,Egypt,0,0,0,0,6,6,12,50,26.820553,30.802498
1988,Finland,0,0,0,0,3,2,5,60,61.92411,25.748151
1988,Ghana,0,0,0,0,1,3,4,25,7.946527,-1.023194
1988,Greece,0,0,0,0,7,8,15,46.666666666666664,39.074208,21.824312
1988,Hungary,0,0,0,0,2,8,10,20,47.162494,19.503304
1988,Indonesia,0,0,0,0,9,3,12,75,-0.789275,113.921327
1988,Iran,0,0,0,0,2,9,11,18.181818181818183,32.427908,53.688046
1988,Israel,0,0,0,0,41,39,80,51.24999999999999,31.046051,34.851612
1988,Jamaica,0,0,0,0,8,3,11,72.72727272727273,18.109581,-77.297508
1988,Japan,0,0,0,0,20,24,44,45.45454545454545,36.204824,138.252924
1988,Kenya,0,0,0,0,6,13,19,31.57894736842105,-0.023559,37.906193
1988,Mexico,0,0,0,0,33,41,74,44.5945945945946,23.634501,-102.552784
1988,Monaco,0,0,0,0,1,3,4,25,43.750298,7.412841
1988,Morocco,0,0,0,0,6,2,8,75,31.791702,-7.09262
1988,Netherlands,0,0,0,0,47,62,109,43.11926605504588,52.132633,5.291266
1988,New Zealand,0,0,0,0,26,56,82,31.70731707317073,-40.900557,174.885971
1988,Nigeria,0,0,0,0,7,17,24,29.166666666666668,9.081999,8.675277
1988,Norway,0,0,0,0,9,3,12,75,60.472024,8.468946
1988,Pakistan,0,0,0,0,7,5,12,58.333333333333336,30.375321,69.345116
1988,Paraguay,0,0,0,0,3,7,10,30,-23.442503,-58.443832
1988,Peru,0,0,0,0,38,40,78,48.717948717948715,-9.189967,-75.015152
1988,Philippines,0,0,0,0,2,6,8,25,12.879721,121.774017
1988,Poland,0,0,0,0,6,7,13,46.15384615384615,51.919438,19.145136
1988,Portugal,0,0,0,0,4,10,14,28.57142857142857,39.399872,-8.224454
1988,Romania,0,0,0,0,6,7,13,46.15384615384615,45.943161,24.96676
1988,Senegal,0,0,0,0,21,18,39,53.84615384615385,14.497401,-14.452362
1988,South Africa,0,0,0,0,74,94,168,44.047619047619044,-30.559482,22.937506
1988,South Korea,0,0,0,0,10,9,19,52.63157894736842,35.907757,127.766922
1988,Sri Lanka,0,0,0,0,5,3,8,62.5,7.873054,80.771797
1988,Syria,0,0,0,0,1,3,4,25,34.802075,38.996815
1988,Taiwan,0,0,0,0,3,5,8,37.5,23.69781,120.960515
1988,Turkey,0,0,0,0,1,3,4,25,38.963745,35.243322
1988,United Kingdom,0,0,0,0,37,72,109,33.94495412844037,55.378051,-3.435973
1988,Venezuela,0,0,0,0,7,9,16,43.75,6.42375,-66.58973
1988,Zimbabwe,0,0,0,0,10,3,13,76.92307692307693,-19.015438,29.154857
1989,Algeria,0,0,0,0,5,2,7,71.42857142857143,28.033886,1.659626
1989,Austria,0,0,0,0,76,61,137,55.47445255474452,47.516231,14.550072
1989,Bahamas,0,0,0,0,15,16,31,48.38709677419355,25.03428,-77.39628
1989,Bahrain,0,0,0,0,3,5,8,37.5,25.930414,50.637772
1989,Bangladesh,0,0,0,0,5,7,12,41.66666666666667,23.684994,90.356331
1989,Belgium,0,0,0,0,18,12,30,60,50.503887,4.469936
1989,Bolivia,0,0,0,0,2,2,4,50,-16.290154,-63.588653
1989,Brazil,0,0,0,0,52,77,129,40.310077519379846,-14.235004,-51.92528
1989,Bulgaria,0,0,0,0,1,2,3,33.33333333333333,42.733883,25.48583
1989,Cameroon,0,0,0,0,5,3,8,62.5,7.369722,12.354722
1989,Canada,0,0,0,0,56,77,133,42.10526315789473,56.130366,-106.346771
1989,Chile,0,0,0,0,17,16,33,51.515151515151516,-35.675147,-71.542969
1989,China,0,0,0,0,1,3,4,25,35.86166,104.195397
1989,Croatia,0,0,0,0,62,61,123,50.40650406504065,45.1,15.2
1989,Cuba,0,0,0,0,5,4,9,55.55555555555556,21.521757,-77.781167
1989,Denmark,0,0,0,0,7,12,19,36.84210526315789,56.26392,9.501785
1989,Dominican Republic,0,0,0,0,2,6,8,25,18.735693,-70.162651
1989,Ecuador,0,0,0,0,35,30,65,53.84615384615385,-1.831239,-78.183406
1989,Egypt,0,0,0,0,1,3,4,25,26.820553,30.802498
1989,Finland,0,0,0,0,15,21,36,41.66666666666667,61.92411,25.748151
1989,Ghana,0,0,0,0,9,3,12,75,7.946527,-1.023194
1989,Greece,0,0,0,0,4,9,13,30.76923076923077,39.074208,21.824312
1989,Hungary,0,0,0,0,6,2,8,75,47.162494,19.503304
1989,India,0,0,0,0,30,36,66,45.45454545454545,20.593684,78.96288
1989,Iran,0,0,0,0,3,5,8,37.5,32.427908,53.688046
1989,Iraq,0,0,0,0,2,2,4,50,33.223191,43.679291
1989,Ireland,0,0,0,0,1,5,6,16.666666666666664,53.41291,-8.24389
1989,Israel,0,0,0,0,40,32,72,55.55555555555556,31.046051,34.851612
1989,Jamaica,0,0,0,0,6,7,13,46.15384615384615,18.109581,-77.297508
1989,Japan,0,0,0,0,10,21,31,32.25806451612903,36.204824,138.252924
1989,Jordan,0,0,0,0,2,2,4,50,30.585164,36.238414
1989,Kenya,0,0,0,0,6,12,18,33.33333333333333,-0.023559,37.906193
1989,Kuwait,0,0,0,0,2,6,8,25,29.31166,47.481766
1989,Luxembourg,0,0,0,0,6,6,12,50,49.815273,6.129583
1989,Malaysia,0,0,0,0,1,3,4,25,4.210484,101.975766
1989,Mexico,0,0,0,0,18,33,51,35.294117647058826,23.634501,-102.552784
1989,Monaco,0,0,0,0,8,3,11,72.72727272727273,43.750298,7.412841
1989,Morocco,0,0,0,0,6,4,10,60,31.791702,-7.09262
1989,Netherlands,0,0,0,0,60,61,121,49.586776859504134,52.132633,5.291266
1989,Nigeria,0,0,0,0,4,11,15,26.666666666666668,9.081999,8.675277
1989,Norway,0,0,0,0,2,2,4,50,60.472024,8.468946
1989,Peru,0,0,0,0,43,35,78,55.12820512820513,-9.189967,-75.015152
1989,Philippines,0,0,0,0,6,4,10,60,12.879721,121.774017
1989,Poland,0,0,0,0,2,2,4,50,51.919438,19.145136
1989,Portugal,0,0,0,0,8,16,24,33.33333333333333,39.399872,-8.224454
1989,Romania,0,0,0,0,1,5,6,16.666666666666664,45.943161,24.96676
1989,Senegal,0,0,0,0,1,18,19,5.263157894736842,14.497401,-14.452362
1989,South Korea,0,0,0,0,10,11,21,47.61904761904761,35.907757,127.766922
1989,Sri Lanka,0,0,0,0,6,6,12,50,7.873054,80.771797
1989,Syria,0,0,0,0,1,3,4,25,34.802075,38.996815
1989,Taiwan,0,0,0,0,1,3,4,25,23.69781,120.960515
1989,Thailand,0,0,0,0,8,3,11,72.72727272727273,15.870032,100.992541
1989,United Kingdom,0,0,0,0,38,57,95,40,55.378051,-3.435973
1989,Uruguay,0,0,0,0,47,39,86,54.65116279069767,-32.522779,-55.765835
1989,Venezuela,0,0,0,0,12,26,38,31.57894736842105,6.42375,-66.58973
1989,Zimbabwe,0,0,0,0,1,3,4,25,-19.015438,29.154857
1990,Algeria,0,0,0,0,1,3,4,25,28.033886,1.659626
1990,Bahamas,0,0,0,0,3,5,8,37.5,25.03428,-77.39628
1990,Bahrain,0,0,0,0,3,5,8,37.5,25.930414,50.637772
1990,Barbados,0,0,0,0,1,5,6,16.666666666666664,13.193887,-59.543198
1990,Belgium,0,0,0,0,17,15,32,53.125,50.503887,4.469936
1990,Bolivia,0,0,0,0,2,2,4,50,-16.290154,-63.588653
1990,Bulgaria,0,0,0,0,9,3,12,75,42.733883,25.48583
1990,Canada,0,0,0,0,61,80,141,43.262411347517734,56.130366,-106.346771
1990,Chile,0,0,0,0,4,10,14,28.57142857142857,-35.675147,-71.542969
1990,China,0,0,0,0,12,4,16,75,35.86166,104.195397
1990,Colombia,0,0,0,0,12,5,17,70.58823529411765,4.570868,-74.297333
1990,Costa Rica,0,0,0,0,1,3,4,25,9.748917,-83.753428
1990,Cuba,0,0,0,0,9,7,16,56.25,21.521757,-77.781167
1990,Denmark,0,0,0,0,9,8,17,52.94117647058824,56.26392,9.501785
1990,Dominican Republic,0,0,0,0,4,4,8,50,18.735693,-70.162651
1990,Egypt,0,0,0,0,3,5,8,37.5,26.820553,30.802498
1990,Finland,0,0,0,0,45,48,93,48.38709677419355,61.92411,25.748151
1990,Ghana,0,0,0,0,2,6,8,25,7.946527,-1.023194
1990,Greece,0,0,0,0,1,6,7,14.285714285714285,39.074208,21.824312
1990,Haiti,0,0,0,0,2,2,4,50,18.971187,-72.285215
1990,India,0,0,0,0,24,29,53,45.28301886792453,20.593684,78.96288
1990,Iran,0,0,0,0,1,4,5,20,32.427908,53.688046
1990,Iraq,0,0,0,0,2,2,4,50,33.223191,43.679291
1990,Ireland,0,0,0,0,2,2,4,50,53.41291,-8.24389
1990,Italy,0,0,0,0,83,121,204,40.68627450980392,41.87194,12.56738
1990,Japan,0,0,0,0,11,22,33,33.33333333333333,36.204824,138.252924
1990,Kenya,0,0,0,0,3,5,8,37.5,-0.023559,37.906193
1990,Kuwait,0,0,0,0,3,5,8,37.5,29.31166,47.481766
1990,Malaysia,0,0,0,0,5,3,8,62.5,4.210484,101.975766
1990,Malta,0,0,0,0,1,3,4,25,35.937496,14.375416
1990,Mexico,0,0,0,0,13,22,35,37.142857142857146,23.634501,-102.552784
1990,Monaco,0,0,0,0,1,3,4,25,43.750298,7.412841
1990,Morocco,0,0,0,0,8,4,12,66.66666666666666,31.791702,-7.09262
1990,Netherlands,0,0,0,0,66,83,149,44.29530201342282,52.132633,5.291266
1990,New Zealand,0,0,0,0,29,39,68,42.64705882352941,-40.900557,174.885971
1990,Nigeria,0,0,0,0,4,8,12,33.33333333333333,9.081999,8.675277
1990,Norway,0,0,0,0,5,7,12,41.66666666666667,60.472024,8.468946
1990,Peru,0,0,0,0,21,29,50,42,-9.189967,-75.015152
1990,Poland,0,0,0,0,11,1,12,91.66666666666666,51.919438,19.145136
1990,Portugal,0,0,0,0,12,18,30,40,39.399872,-8.224454
1990,Romania,0,0,0,0,5,6,11,45.45454545454545,45.943161,24.96676
1990,Slovakia,0,0,0,0,23,25,48,47.91666666666667,48.669026,19.699024
1990,South Korea,0,0,0,0,4,8,12,33.33333333333333,35.907757,127.766922
1990,Sri Lanka,0,0,0,0,4,4,8,50,7.873054,80.771797
1990,Syria,0,0,0,0,1,3,4,25,34.802075,38.996815
1990,Taiwan,0,0,0,0,8,4,12,66.66666666666666,23.69781,120.960515
1990,Thailand,0,0,0,0,10,2,12,83.33333333333334,15.870032,100.992541
1990,Togo,0,0,0,0,4,4,8,50,8.619543,0.824782
1990,Turkey,0,0,0,0,5,3,8,62.5,38.963745,35.243322
1990,Ukraine,0,0,0,0,1,3,4,25,48.379433,31.16558
1990,United Kingdom,0,0,0,0,16,43,59,27.11864406779661,55.378051,-3.435973
1990,Uruguay,0,0,0,0,43,46,89,48.31460674157304,-32.522779,-55.765835
1990,Venezuela,0,0,0,0,13,20,33,39.39393939393939,6.42375,-66.58973
1990,Zambia,0,0,0,0,1,3,4,25,-13.133897,27.849332
1990,Zimbabwe,0,0,0,0,8,4,12,66.66666666666666,-19.015438,29.154857
1991,Algeria,0,0,0,0,2,2,4,50,28.033886,1.659626
1991,Bahamas,0,0,0,0,10,10,20,50,25.03428,-77.39628
1991,Bahrain,0,0,0,0,2,2,4,50,25.930414,50.637772
1991,Bangladesh,0,0,0,0,2,6,8,25,23.684994,90.356331
1991,Belgium,0,0,0,0,27,45,72,37.5,50.503887,4.469936
1991,Bolivia,0,0,0,0,2,2,4,50,-16.290154,-63.588653
1991,Brazil,0,0,0,0,80,91,171,46.783625730994146,-14.235004,-51.92528
1991,Cameroon,0,0,0,0,1,3,4,25,7.369722,12.354722
1991,Canada,0,0,0,0,47,68,115,40.869565217391305,56.130366,-106.346771
1991,Chile,0,0,0,0,14,18,32,43.75,-35.675147,-71.542969
1991,China,0,0,0,0,1,3,4,25,35.86166,104.195397
1991,Colombia,0,0,0,0,12,4,16,75,4.570868,-74.297333
1991,Costa Rica,0,0,0,0,1,3,4,25,9.748917,-83.753428
1991,Cuba,0,0,0,0,6,2,8,75,21.521757,-77.781167
1991,Denmark,0,0,0,0,8,7,15,53.333333333333336,56.26392,9.501785
1991,Dominican Republic,0,0,0,0,3,5,8,37.5,18.735693,-70.162651
1991,Ecuador,0,0,0,0,25,23,48,52.083333333333336,-1.831239,-78.183406
1991,Egypt,0,0,0,0,8,4,12,66.66666666666666,26.820553,30.802498
1991,El Salvador,0,0,0,0,2,4,6,33.33333333333333,13.794185,-88.89653
1991,Finland,0,0,0,0,20,41,61,32.78688524590164,61.92411,25.748151
1991,Greece,0,0,0,0,5,5,10,50,39.074208,21.824312
1991,Guatemala,0,0,0,0,1,3,4,25,15.783471,-90.230759
1991,Haiti,0,0,0,0,1,5,6,16.666666666666664,18.971187,-72.285215
1991,Hungary,0,0,0,0,4,5,9,44.44444444444444,47.162494,19.503304
1991,India,0,0,0,0,19,27,46,41.30434782608695,20.593684,78.96288
1991,Indonesia,0,0,0,0,1,2,3,33.33333333333333,-0.789275,113.921327
1991,Israel,0,0,0,0,37,61,98,37.755102040816325,31.046051,34.851612
1991,Jamaica,0,0,0,0,1,3,4,25,18.109581,-77.297508
1991,Japan,0,0,0,0,23,30,53,43.39622641509434,36.204824,138.252924
1991,Kenya,0,0,0,0,12,5,17,70.58823529411765,-0.023559,37.906193
1991,Latvia,0,0,0,0,1,1,2,50,56.879635,24.603189
1991,Luxembourg,0,0,0,0,9,3,12,75,49.815273,6.129583
1991,Malaysia,0,0,0,0,5,3,8,62.5,4.210484,101.975766
1991,Malta,0,0,0,0,1,3,4,25,35.937496,14.375416
1991,Mexico,0,0,0,0,20,34,54,37.03703703703704,23.634501,-102.552784
1991,New Zealand,0,0,0,0,7,28,35,20,-40.900557,174.885971
1991,Nigeria,0,0,0,0,4,5,9,44.44444444444444,9.081999,8.675277
1991,Norway,0,0,0,0,10,2,12,83.33333333333334,60.472024,8.468946
1991,Pakistan,0,0,0,0,4,4,8,50,30.375321,69.345116
1991,Peru,0,0,0,0,33,30,63,52.38095238095239,-9.189967,-75.015152
1991,Philippines,0,0,0,0,9,7,16,56.25,12.879721,121.774017
1991,Poland,0,0,0,0,6,5,11,54.54545454545454,51.919438,19.145136
1991,Portugal,0,0,0,0,14,27,41,34.146341463414636,39.399872,-8.224454
1991,Romania,0,0,0,0,7,8,15,46.666666666666664,45.943161,24.96676
1991,Saudi Arabia,0,0,0,0,1,3,4,25,23.885942,45.079162
1991,Senegal,0,0,0,0,1,5,6,16.666666666666664,14.497401,-14.452362
1991,Slovakia,0,0,0,0,19,28,47,40.42553191489361,48.669026,19.699024
1991,South Africa,0,0,0,0,66,76,142,46.478873239436616,-30.559482,22.937506
1991,South Korea,0,0,0,0,4,7,11,36.36363636363637,35.907757,127.766922
1991,Sri Lanka,0,0,0,0,10,2,12,83.33333333333334,7.873054,80.771797
1991,Taiwan,0,0,0,0,8,5,13,61.53846153846154,23.69781,120.960515
1991,Turkey,0,0,0,0,3,5,8,37.5,38.963745,35.243322
1991,Ukraine,0,0,0,0,17,18,35,48.57142857142857,48.379433,31.16558
1991,United Kingdom,0,0,0,0,15,27,42,35.714285714285715,55.378051,-3.435973
1991,Uruguay,0,0,0,0,15,33,48,31.25,-32.522779,-55.765835
1991,Venezuela,0,0,0,0,11,16,27,40.74074074074074,6.42375,-66.58973
1991,Zambia,0,0,0,0,5,3,8,62.5,-13.133897,27.849332
1991,Zimbabwe,0,0,0,0,3,6,9,33.33333333333333,-19.015438,29.154857
1992,Bahamas,0,0,0,0,10,6,16,62.5,25.03428,-77.39628
1992,Bangladesh,0,0,0,0,2,6,8,25,23.684994,90.356331
1992,Belgium,0,0,0,0,22,51,73,30.136986301369863,50.503887,4.469936
1992,Bulgaria,0,0,0,0,7,4,11,63.63636363636363,42.733883,25.48583
1992,Canada,0,0,0,0,32,53,85,37.64705882352941,56.130366,-106.346771
1992,Chile,0,0,0,0,2,6,8,25,-35.675147,-71.542969
1992,China,0,0,0,0,1,10,11,9.090909090909092,35.86166,104.195397
1992,Colombia,0,0,0,0,5,3,8,62.5,4.570868,-74.297333
1992,Cuba,0,0,0,0,6,2,8,75,21.521757,-77.781167
1992,Denmark,0,0,0,0,17,14,31,54.83870967741935,56.26392,9.501785
1992,Dominican Republic,0,0,0,0,4,4,8,50,18.735693,-70.162651
1992,Ecuador,0,0,0,0,14,21,35,40,-1.831239,-78.183406
1992,Egypt,0,0,0,0,5,3,8,62.5,26.820553,30.802498
1992,Finland,0,0,0,0,7,10,17,41.17647058823529,61.92411,25.748151
1992,Georgia,0,0,0,0,2,2,4,50,42.315407,43.356892
1992,Ghana,0,0,0,0,3,4,7,42.857142857142854,7.946527,-1.023194
1992,Greece,0,0,0,0,6,8,14,42.857142857142854,39.074208,21.824312
1992,Hungary,0,0,0,0,2,7,9,22.22222222222222,47.162494,19.503304
1992,India,0,0,0,0,11,7,18,61.111111111111114,20.593684,78.96288
1992,Indonesia,0,0,0,0,1,3,4,25,-0.789275,113.921327
1992,Ireland,0,0,0,0,5,4,9,55.55555555555556,53.41291,-8.24389
1992,Israel,0,0,0,0,53,47,100,53,31.046051,34.851612
1992,Jordan,0,0,0,0,4,4,8,50,30.585164,36.238414
1992,Kenya,0,0,0,0,2,7,9,22.22222222222222,-0.023559,37.906193
1992,Latvia,0,0,0,0,2,5,7,28.57142857142857,56.879635,24.603189
1992,Luxembourg,0,0,0,0,9,3,12,75,49.815273,6.129583
1992,Malaysia,0,0,0,0,5,3,8,62.5,4.210484,101.975766
1992,Mexico,0,0,0,0,26,33,59,44.06779661016949,23.634501,-102.552784
1992,Monaco,0,0,0,0,5,3,8,62.5,43.750298,7.412841
1992,Morocco,0,0,0,0,8,6,14,57.14285714285714,31.791702,-7.09262
1992,New Zealand,0,0,0,0,17,17,34,50,-40.900557,174.885971
1992,Norway,0,0,0,0,5,5,10,50,60.472024,8.468946
1992,Pakistan,0,0,0,0,5,3,8,62.5,30.375321,69.345116
1992,Paraguay,0,0,0,0,1,3,4,25,-23.442503,-58.443832
1992,Peru,0,0,0,0,37,34,71,52.112676056338024,-9.189967,-75.015152
1992,Philippines,0,0,0,0,3,6,9,33.33333333333333,12.879721,121.774017
1992,Poland,0,0,0,0,2,6,8,25,51.919438,19.145136
1992,Portugal,0,0,0,0,8,15,23,34.78260869565217,39.399872,-8.224454
1992,Romania,0,0,0,0,3,6,9,33.33333333333333,45.943161,24.96676
1992,Russia,0,0,0,0,133,115,248,53.62903225806451,61.52401,105.318756
1992,Slovakia,0,0,0,0,2,12,14,14.285714285714285,48.669026,19.699024
1992,South Korea,0,0,0,0,12,14,26,46.15384615384615,35.907757,127.766922
1992,Sri Lanka,0,0,0,0,3,5,8,37.5,7.873054,80.771797
1992,Taiwan,0,0,0,0,3,8,11,27.27272727272727,23.69781,120.960515
1992,Thailand,0,0,0,0,8,4,12,66.66666666666666,15.870032,100.992541
1992,Togo,0,0,0,0,3,4,7,42.857142857142854,8.619543,0.824782
1992,Ukraine,0,0,0,0,34,21,55,61.81818181818181,48.379433,31.16558
1992,United Kingdom,0,0,0,0,13,35,48,27.083333333333332,55.378051,-3.435973
1992,Uruguay,0,0,0,0,39,36,75,52,-32.522779,-55.765835
1992,Venezuela,0,0,0,0,8,7,15,53.333333333333336,6.42375,-66.58973
1992,Zambia,0,0,0,0,1,7,8,12.5,-13.133897,27.849332
1992,Zimbabwe,0,0,0,0,21,23,44,47.72727272727273,-19.015438,29.154857
1993,Algeria,0,0,0,0,1,7,8,12.5,28.033886,1.659626
1993,Armenia,0,0,0,0,1,1,2,50,40.069099,45.038189
1993,Bahamas,0,0,0,0,8,10,18,44.44444444444444,25.03428,-77.39628
1993,Belgium,0,0,0,0,22,28,50,44,50.503887,4.469936
1993,Brazil,0,0,0,0,37,64,101,36.633663366336634,-14.235004,-51.92528
1993,Bulgaria,0,0,0,0,4,7,11,36.36363636363637,42.733883,25.48583
1993,Canada,0,0,0,0,18,37,55,32.72727272727273,56.130366,-106.346771
1993,Chile,0,0,0,0,10,13,23,43.47826086956522,-35.675147,-71.542969
1993,China,0,0,0,0,10,7,17,58.82352941176471,35.86166,104.195397
1993,Colombia,0,0,0,0,8,9,17,47.05882352941176,4.570868,-74.297333
1993,Denmark,0,0,0,0,21,37,58,36.206896551724135,56.26392,9.501785
1993,Dominican Republic,0,0,0,0,2,6,8,25,18.735693,-70.162651
1993,Ecuador,0,0,0,0,8,9,17,47.05882352941176,-1.831239,-78.183406
1993,Egypt,0,0,0,0,5,3,8,62.5,26.820553,30.802498
1993,Finland,0,0,0,0,2,2,4,50,61.92411,25.748151
1993,Ghana,0,0,0,0,4,4,8,50,7.946527,-1.023194
1993,Greece,0,0,0,0,6,5,11,54.54545454545454,39.074208,21.824312
1993,Hungary,0,0,0,0,6,5,11,54.54545454545454,47.162494,19.503304
1993,India,0,0,0,0,8,13,21,38.095238095238095,20.593684,78.96288
1993,Indonesia,0,0,0,0,1,4,5,20,-0.789275,113.921327
1993,Iran,0,0,0,0,5,3,8,62.5,32.427908,53.688046
1993,Ireland,0,0,0,0,5,2,7,71.42857142857143,53.41291,-8.24389
1993,Japan,0,0,0,0,23,30,53,43.39622641509434,36.204824,138.252924
1993,Jordan,0,0,0,0,1,7,8,12.5,30.585164,36.238414
1993,Kenya,0,0,0,0,1,3,4,25,-0.023559,37.906193
1993,Kuwait,0,0,0,0,2,10,12,16.666666666666664,29.31166,47.481766
1993,Luxembourg,0,0,0,0,3,5,8,37.5,49.815273,6.129583
1993,Malaysia,0,0,0,0,4,7,11,36.36363636363637,4.210484,101.975766
1993,Mexico,0,0,0,0,22,36,58,37.93103448275862,23.634501,-102.552784
1993,Monaco,0,0,0,0,2,4,6,33.33333333333333,43.750298,7.412841
1993,Morocco,0,0,0,0,24,19,43,55.81395348837209,31.791702,-7.09262
1993,New Zealand,0,0,0,0,35,36,71,49.29577464788733,-40.900557,174.885971
1993,Nigeria,0,0,0,0,5,3,8,62.5,9.081999,8.675277
1993,Norway,0,0,0,0,5,9,14,35.714285714285715,60.472024,8.468946
1993,Pakistan,0,0,0,0,1,3,4,25,30.375321,69.345116
1993,Paraguay,0,0,0,0,3,5,8,37.5,-23.442503,-58.443832
1993,Philippines,0,0,0,0,5,3,8,62.5,12.879721,121.774017
1993,Poland,0,0,0,0,3,4,7,42.857142857142854,51.919438,19.145136
1993,Portugal,0,0,0,0,10,23,33,30.303030303030305,39.399872,-8.224454
1993,Romania,0,0,0,0,12,5,17,70.58823529411765,45.943161,24.96676
1993,Senegal,0,0,0,0,6,8,14,42.857142857142854,14.497401,-14.452362
1993,Slovakia,0,0,0,0,1,5,6,16.666666666666664,48.669026,19.699024
1993,South Africa,0,0,0,0,113,108,221,51.13122171945701,-30.559482,22.937506
1993,South Korea,0,0,0,0,6,9,15,40,35.907757,127.766922
1993,Sri Lanka,0,0,0,0,5,3,8,62.5,7.873054,80.771797
1993,Switzerland,0,0,0,0,83,77,160,51.87500000000001,46.818188,8.227512
1993,Taiwan,0,0,0,0,1,7,8,12.5,23.69781,120.960515
1993,Thailand,0,0,0,0,9,3,12,75,15.870032,100.992541
1993,Uruguay,0,0,0,0,20,42,62,32.25806451612903,-32.522779,-55.765835
1993,Venezuela,0,0,0,0,7,19,26,26.923076923076923,6.42375,-66.58973
1993,Zimbabwe,0,0,0,0,25,27,52,48.07692307692308,-19.015438,29.154857
1994,Bahamas,0,0,0,0,8,18,26,30.76923076923077,25.03428,-77.39628
1994,Belgium,0,0,0,0,15,32,47,31.914893617021278,50.503887,4.469936
1994,Bulgaria,0,0,0,0,1,10,11,9.090909090909092,42.733883,25.48583
1994,Canada,0,0,0,0,21,35,56,37.5,56.130366,-106.346771
1994,Chile,0,0,0,0,16,19,35,45.714285714285715,-35.675147,-71.542969
1994,Colombia,0,0,0,0,17,20,37,45.94594594594595,4.570868,-74.297333
1994,Denmark,0,0,0,0,24,28,52,46.15384615384615,56.26392,9.501785
1994,Ecuador,0,0,0,0,4,6,10,40,-1.831239,-78.183406
1994,Egypt,0,0,0,0,3,7,10,30,26.820553,30.802498
1994,Estonia,0,0,0,0,1,3,4,25,58.595272,25.013607
1994,Finland,0,0,0,0,5,3,8,62.5,61.92411,25.748151
1994,France,0,0,0,0,220,271,491,44.806517311608964,46.227638,2.213749
1994,Ghana,0,0,0,0,7,5,12,58.333333333333336,7.946527,-1.023194
1994,Greece,0,0,0,0,2,9,11,18.181818181818183,39.074208,21.824312
1994,Guatemala,0,0,0,0,4,4,8,50,15.783471,-90.230759
1994,Hungary,0,0,0,0,7,12,19,36.84210526315789,47.162494,19.503304
1994,India,0,0,0,0,4,9,13,30.76923076923077,20.593684,78.96288
1994,Indonesia,0,0,0,0,3,5,8,37.5,-0.789275,113.921327
1994,Iran,0,0,0,0,6,6,12,50,32.427908,53.688046
1994,Ireland,0,0,0,0,2,4,6,33.33333333333333,53.41291,-8.24389
1994,Israel,0,0,0,0,26,37,63,41.269841269841265,31.046051,34.851612
1994,Japan,0,0,0,0,18,27,45,40,36.204824,138.252924
1994,Kenya,0,0,0,0,2,6,8,25,-0.023559,37.906193
1994,Kuwait,0,0,0,0,3,1,4,75,29.31166,47.481766
1994,Latvia,0,0,0,0,5,6,11,45.45454545454545,56.879635,24.603189
1994,Luxembourg,0,0,0,0,1,3,4,25,49.815273,6.129583
1994,Malaysia,0,0,0,0,6,5,11,54.54545454545454,4.210484,101.975766
1994,Mexico,0,0,0,0,8,13,21,38.095238095238095,23.634501,-102.552784
1994,Monaco,0,0,0,0,5,3,8,62.5,43.750298,7.412841
1994,Morocco,0,0,0,0,38,49,87,43.67816091954023,31.791702,-7.09262
1994,New Zealand,0,0,0,0,25,33,58,43.103448275862064,-40.900557,174.885971
1994,Nigeria,0,0,0,0,6,4,10,60,9.081999,8.675277
1994,Norway,0,0,0,0,4,6,10,40,60.472024,8.468946
1994,Pakistan,0,0,0,0,3,1,4,75,30.375321,69.345116
1994,Paraguay,0,0,0,0,5,3,8,62.5,-23.442503,-58.443832
1994,Peru,0,0,0,0,35,39,74,47.2972972972973,-9.189967,-75.015152
1994,Poland,0,0,0,0,4,4,8,50,51.919438,19.145136
1994,Portugal,0,0,0,0,6,13,19,31.57894736842105,39.399872,-8.224454
1994,Romania,0,0,0,0,8,13,21,38.095238095238095,45.943161,24.96676
1994,Saudi Arabia,0,0,0,0,2,6,8,25,23.885942,45.079162
1994,Senegal,0,0,0,0,1,7,8,12.5,14.497401,-14.452362
1994,Slovakia,0,0,0,0,13,15,28,46.42857142857143,48.669026,19.699024
1994,Slovenia,0,0,0,0,8,4,12,66.66666666666666,46.151241,14.995463
1994,South Korea,0,0,0,0,3,11,14,21.428571428571427,35.907757,127.766922
1994,Sri Lanka,0,0,0,0,4,4,8,50,7.873054,80.771797
1994,Taiwan,0,0,0,0,13,8,21,61.904761904761905,23.69781,120.960515
1994,Thailand,0,0,0,0,5,3,8,62.5,15.870032,100.992541
1994,United Kingdom,0,0,0,0,60,92,152,39.473684210526315,55.378051,-3.435973
1994,Uruguay,0,0,0,0,32,22,54,59.25925925925925,-32.522779,-55.765835
1994,Venezuela,0,0,0,0,31,41,72,43.05555555555556,6.42375,-66.58973
1994,Zimbabwe,0,0,0,0,28,38,66,42.42424242424242,-19.015438,29.154857
1995,Armenia,0,0,0,0,2,2,4,50,40.069099,45.038189
1995,Bahamas,0,0,0,0,5,13,18,27.77777777777778,25.03428,-77.39628
1995,Belarus,0,0,0,0,5,4,9,55.55555555555556,53.709807,27.953389
1995,Belgium,0,0,0,0,36,37,73,49.31506849315068,50.503887,4.469936
1995,Bolivia,0,0,0,0,1,7,8,12.5,-16.290154,-63.588653
1995,Canada,0,0,0,0,26,40,66,39.39393939393939,56.130366,-106.346771
1995,China,0,0,0,0,9,9,18,50,35.86166,104.195397
1995,Cuba,0,0,0,0,6,2,8,75,21.521757,-77.781167
1995,Denmark,0,0,0,0,40,38,78,51.28205128205128,56.26392,9.501785
1995,Ecuador,0,0,0,0,16,6,22,72.72727272727273,-1.831239,-78.183406
1995,Egypt,0,0,0,0,7,5,12,58.333333333333336,26.820553,30.802498
1995,Estonia,0,0,0,0,1,7,8,12.5,58.595272,25.013607
1995,Finland,0,0,0,0,10,2,12,83.33333333333334,61.92411,25.748151
1995,Ghana,0,0,0,0,3,5,8,37.5,7.946527,-1.023194
1995,Guatemala,0,0,0,0,3,5,8,37.5,15.783471,-90.230759
1995,Haiti,0,0,0,0,2,2,4,50,18.971187,-72.285215
1995,Hungary,0,0,0,0,13,17,30,43.333333333333336,47.162494,19.503304
1995,India,0,0,0,0,12,13,25,48,20.593684,78.96288
1995,Indonesia,0,0,0,0,3,8,11,27.27272727272727,-0.789275,113.921327
1995,Iran,0,0,0,0,5,3,8,62.5,32.427908,53.688046
1995,Ireland,0,0,0,0,3,5,8,37.5,53.41291,-8.24389
1995,Israel,0,0,0,0,8,13,21,38.095238095238095,31.046051,34.851612
1995,Italy,0,0,0,0,133,154,287,46.34146341463415,41.87194,12.56738
1995,Japan,0,0,0,0,24,29,53,45.28301886792453,36.204824,138.252924
1995,Kenya,0,0,0,0,8,20,28,28.57142857142857,-0.023559,37.906193
1995,Latvia,0,0,0,0,5,5,10,50,56.879635,24.603189
1995,Lithuania,0,0,0,0,2,6,8,25,55.169438,23.881275
1995,Luxembourg,0,0,0,0,6,6,12,50,49.815273,6.129583
1995,Malaysia,0,0,0,0,2,8,10,20,4.210484,101.975766
1995,Mexico,0,0,0,0,13,20,33,39.39393939393939,23.634501,-102.552784
1995,Morocco,0,0,0,0,23,30,53,43.39622641509434,31.791702,-7.09262
1995,New Zealand,0,0,0,0,41,31,72,56.94444444444444,-40.900557,174.885971
1995,Nigeria,0,0,0,0,4,6,10,40,9.081999,8.675277
1995,Norway,0,0,0,0,18,29,47,38.297872340425535,60.472024,8.468946
1995,Pakistan,0,0,0,0,1,3,4,25,30.375321,69.345116
1995,Paraguay,0,0,0,0,4,4,8,50,-23.442503,-58.443832
1995,Peru,0,0,0,0,19,29,48,39.58333333333333,-9.189967,-75.015152
1995,Philippines,0,0,0,0,3,5,8,37.5,12.879721,121.774017
1995,Poland,0,0,0,0,6,8,14,42.857142857142854,51.919438,19.145136
1995,Portugal,0,0,0,0,12,26,38,31.57894736842105,39.399872,-8.224454
1995,Romania,0,0,0,0,21,33,54,38.88888888888889,45.943161,24.96676
1995,Slovakia,0,0,0,0,35,40,75,46.666666666666664,48.669026,19.699024
1995,South Africa,0,0,0,0,86,78,164,52.4390243902439,-30.559482,22.937506
1995,South Korea,0,0,0,0,6,7,13,46.15384615384615,35.907757,127.766922
1995,Sri Lanka,0,0,0,0,3,5,8,37.5,7.873054,80.771797
1995,Taiwan,0,0,0,0,5,8,13,38.46153846153847,23.69781,120.960515
1995,Thailand,0,0,0,0,5,3,8,62.5,15.870032,100.992541
1995,Ukraine,0,0,0,0,50,35,85,58.82352941176471,48.379433,31.16558
1995,Uruguay,0,0,0,0,16,31,47,34.04255319148936,-32.522779,-55.765835
1995,Uzbekistan,0,0,0,0,14,6,20,70,41.377491,64.585262
1995,Venezuela,0,0,0,0,21,24,45,46.666666666666664,6.42375,-66.58973
1995,Zimbabwe,0,0,0,0,36,34,70,51.42857142857142,-19.015438,29.154857
1996,Armenia,0,0,0,0,4,6,10,40,40.069099,45.038189
1996,Bahamas,0,0,0,0,13,24,37,35.13513513513514,25.03428,-77.39628
1996,Bahrain,0,0,0,0,1,7,8,12.5,25.930414,50.637772
1996,Belarus,0,0,0,0,3,8,11,27.27272727272727,53.709807,27.953389
1996,Belgium,0,0,0,0,42,86,128,32.8125,50.503887,4.469936
1996,Brazil,0,0,0,0,35,37,72,48.61111111111111,-14.235004,-51.92528
1996,Bulgaria,0,0,0,0,2,1,3,66.66666666666666,42.733883,25.48583
1996,Canada,0,0,0,0,29,39,68,42.64705882352941,56.130366,-106.346771
1996,China,0,0,0,0,5,7,12,41.66666666666667,35.86166,104.195397
1996,Colombia,0,0,0,0,16,22,38,42.10526315789473,4.570868,-74.297333
1996,Cuba,0,0,0,0,2,4,6,33.33333333333333,21.521757,-77.781167
1996,Denmark,0,0,0,0,27,52,79,34.177215189873415,56.26392,9.501785
1996,Ecuador,0,0,0,0,27,35,62,43.54838709677419,-1.831239,-78.183406
1996,Egypt,0,0,0,0,8,9,17,47.05882352941176,26.820553,30.802498
1996,Finland,0,0,0,0,3,7,10,30,61.92411,25.748151
1996,Ghana,0,0,0,0,4,4,8,50,7.946527,-1.023194
1996,Guatemala,0,0,0,0,1,7,8,12.5,15.783471,-90.230759
1996,Hungary,0,0,0,0,6,30,36,16.666666666666664,47.162494,19.503304
1996,India,0,0,0,0,17,19,36,47.22222222222222,20.593684,78.96288
1996,Indonesia,0,0,0,0,2,13,15,13.333333333333334,-0.789275,113.921327
1996,Iran,0,0,0,0,4,4,8,50,32.427908,53.688046
1996,Israel,0,0,0,0,6,15,21,28.57142857142857,31.046051,34.851612
1996,Italy,0,0,0,0,111,153,264,42.04545454545455,41.87194,12.56738
1996,Japan,0,0,0,0,18,34,52,34.61538461538461,36.204824,138.252924
1996,Latvia,0,0,0,0,4,4,8,50,56.879635,24.603189
1996,Luxembourg,0,0,0,0,1,3,4,25,49.815273,6.129583
1996,Mexico,0,0,0,0,9,15,24,37.5,23.634501,-102.552784
1996,New Zealand,0,0,0,0,21,23,44,47.72727272727273,-40.900557,174.885971
1996,Nigeria,0,0,0,0,1,4,5,20,9.081999,8.675277
1996,Norway,0,0,0,0,27,29,56,48.214285714285715,60.472024,8.468946
1996,Pakistan,0,0,0,0,4,4,8,50,30.375321,69.345116
1996,Paraguay,0,0,0,0,8,4,12,66.66666666666666,-23.442503,-58.443832
1996,Peru,0,0,0,0,4,8,12,33.33333333333333,-9.189967,-75.015152
1996,Philippines,0,0,0,0,3,9,12,25,12.879721,121.774017
1996,Poland,0,0,0,0,11,7,18,61.111111111111114,51.919438,19.145136
1996,Portugal,0,0,0,0,16,34,50,32,39.399872,-8.224454
1996,Romania,0,0,0,0,40,38,78,51.28205128205128,45.943161,24.96676
1996,Saudi Arabia,0,0,0,0,3,5,8,37.5,23.885942,45.079162
1996,Serbia,0,0,0,0,4,2,6,66.66666666666666,44.016521,21.005859
1996,Slovakia,0,0,0,0,44,45,89,49.43820224719101,48.669026,19.699024
1996,Slovenia,0,0,0,0,5,3,8,62.5,46.151241,14.995463
1996,South Korea,0,0,0,0,6,6,12,50,35.907757,127.766922
1996,Sri Lanka,0,0,0,0,1,7,8,12.5,7.873054,80.771797
1996,Taiwan,0,0,0,0,3,7,10,30,23.69781,120.960515
1996,Thailand,0,0,0,0,7,6,13,53.84615384615385,15.870032,100.992541
1996,United Kingdom,0,0,0,0,103,86,189,54.4973544973545,55.378051,-3.435973
1996,Uruguay,0,0,0,0,23,20,43,53.48837209302325,-32.522779,-55.765835
1996,Uzbekistan,0,0,0,0,20,18,38,52.63157894736842,41.377491,64.585262
1996,Venezuela,0,0,0,0,20,32,52,38.46153846153847,6.42375,-66.58973
1997,Argentina,0,0,0,0,60,92,152,39.473684210526315,-38.416097,-63.616672
1997,Armenia,0,0,0,0,18,23,41,43.90243902439025,40.069099,45.038189
1997,Bahamas,0,0,0,0,6,15,21,28.57142857142857,25.03428,-77.39628
1997,Belarus,0,0,0,0,5,7,12,41.66666666666667,53.709807,27.953389
1997,Belgium,0,0,0,0,46,54,100,46,50.503887,4.469936
1997,Bosnia and Herzegovina,0,0,0,0,3,1,4,75,43.915886,17.679076
1997,Bulgaria,0,0,0,0,1,13,14,7.142857142857142,42.733883,25.48583
1997,Canada,0,0,0,0,25,42,67,37.3134328358209,56.130366,-106.346771
1997,China,0,0,0,0,4,7,11,36.36363636363637,35.86166,104.195397
1997,Colombia,0,0,0,0,11,6,17,64.70588235294117,4.570868,-74.297333
1997,Costa Rica,0,0,0,0,9,13,22,40.909090909090914,9.748917,-83.753428
1997,Cuba,0,0,0,0,5,3,8,62.5,21.521757,-77.781167
1997,Denmark,0,0,0,0,35,39,74,47.2972972972973,56.26392,9.501785
1997,Ecuador,0,0,0,0,20,23,43,46.51162790697674,-1.831239,-78.183406
1997,Egypt,0,0,0,0,3,11,14,21.428571428571427,26.820553,30.802498
1997,El Salvador,0,0,0,0,3,5,8,37.5,13.794185,-88.89653
1997,Finland,0,0,0,0,6,8,14,42.857142857142854,61.92411,25.748151
1997,Georgia,0,0,0,0,5,2,7,71.42857142857143,42.315407,43.356892
1997,Ghana,0,0,0,0,1,6,7,14.285714285714285,7.946527,-1.023194
1997,Greece,0,0,0,0,3,5,8,37.5,39.074208,21.824312
1997,Haiti,0,0,0,0,2,6,8,25,18.971187,-72.285215
1997,Hungary,0,0,0,0,3,9,12,25,47.162494,19.503304
1997,India,0,0,0,0,17,31,48,35.41666666666667,20.593684,78.96288
1997,Indonesia,0,0,0,0,2,6,8,25,-0.789275,113.921327
1997,Iran,0,0,0,0,6,6,12,50,32.427908,53.688046
1997,Ireland,0,0,0,0,4,4,8,50,53.41291,-8.24389
1997,Israel,0,0,0,0,8,21,29,27.586206896551722,31.046051,34.851612
1997,Italy,0,0,0,0,70,119,189,37.03703703703704,41.87194,12.56738
1997,Japan,0,0,0,0,7,16,23,30.434782608695656,36.204824,138.252924
1997,Latvia,0,0,0,0,3,5,8,37.5,56.879635,24.603189
1997,Lithuania,0,0,0,0,4,4,8,50,55.169438,23.881275
1997,Mexico,0,0,0,0,6,20,26,23.076923076923077,23.634501,-102.552784
1997,Morocco,0,0,0,0,54,62,116,46.55172413793103,31.791702,-7.09262
1997,New Zealand,0,0,0,0,28,24,52,53.84615384615385,-40.900557,174.885971
1997,Norway,0,0,0,0,34,26,60,56.666666666666664,60.472024,8.468946
1997,Pakistan,0,0,0,0,6,2,8,75,30.375321,69.345116
1997,Paraguay,0,0,0,0,8,8,16,50,-23.442503,-58.443832
1997,Peru,0,0,0,0,2,7,9,22.22222222222222,-9.189967,-75.015152
1997,Philippines,0,0,0,0,4,13,17,23.52941176470588,12.879721,121.774017
1997,Poland,0,0,0,0,9,3,12,75,51.919438,19.145136
1997,Portugal,0,0,0,0,11,16,27,40.74074074074074,39.399872,-8.224454
1997,Romania,0,0,0,0,28,61,89,31.46067415730337,45.943161,24.96676
1997,Saudi Arabia,0,0,0,0,1,7,8,12.5,23.885942,45.079162
1997,Serbia,0,0,0,0,1,3,4,25,44.016521,21.005859
1997,Slovenia,0,0,0,0,2,6,8,25,46.151241,14.995463
1997,South Africa,0,0,0,0,72,78,150,48,-30.559482,22.937506
1997,South Korea,0,0,0,0,8,4,12,66.66666666666666,35.907757,127.766922
1997,Taiwan,0,0,0,0,5,3,8,62.5,23.69781,120.960515
1997,Thailand,0,0,0,0,4,5,9,44.44444444444444,15.870032,100.992541
1997,Ukraine,0,0,0,0,34,32,66,51.515151515151516,48.379433,31.16558
1997,Uruguay,0,0,0,0,32,27,59,54.23728813559322,-32.522779,-55.765835
1997,Uzbekistan,0,0,0,0,11,18,29,37.93103448275862,41.377491,64.585262
1997,Venezuela,0,0,0,0,3,18,21,14.285714285714285,6.42375,-66.58973
1997,Zimbabwe,0,0,0,0,44,40,84,52.38095238095239,-19.015438,29.154857
1998,Armenia,0,0,0,0,18,25,43,41.86046511627907,40.069099,45.038189
1998,Austria,0,0,0,0,48,43,91,52.74725274725275,47.516231,14.550072
1998,Bahamas,0,0,0,0,4,13,17,23.52941176470588,25.03428,-77.39628
1998,Belarus,0,0,0,0,13,8,21,61.904761904761905,53.709807,27.953389
1998,Belgium,0,0,0,0,49,59,108,45.370370370370374,50.503887,4.469936
1998,Brazil,0,0,0,0,65,60,125,52,-14.235004,-51.92528
1998,Bulgaria,0,0,0,0,6,5,11,54.54545454545454,42.733883,25.48583
1998,Canada,0,0,0,0,34,43,77,44.15584415584416,56.130366,-106.346771
1998,China,0,0,0,0,5,9,14,35.714285714285715,35.86166,104.195397
1998,Colombia,0,0,0,0,4,12,16,25,4.570868,-74.297333
1998,Costa Rica,0,0,0,0,20,27,47,42.5531914893617,9.748917,-83.753428
1998,Cuba,0,0,0,0,3,5,8,37.5,21.521757,-77.781167
1998,Denmark,0,0,0,0,25,32,57,43.859649122807014,56.26392,9.501785
1998,Ecuador,0,0,0,0,25,37,62,40.32258064516129,-1.831239,-78.183406
1998,Egypt,0,0,0,0,2,6,8,25,26.820553,30.802498
1998,Finland,0,0,0,0,5,15,20,25,61.92411,25.748151
1998,France,0,0,0,0,211,236,447,47.20357941834452,46.227638,2.213749
1998,Guatemala,0,0,0,0,3,5,8,37.5,15.783471,-90.230759
1998,Haiti,0,0,0,0,1,3,4,25,18.971187,-72.285215
1998,Hungary,0,0,0,0,8,8,16,50,47.162494,19.503304
1998,India,0,0,0,0,15,19,34,44.11764705882353,20.593684,78.96288
1998,Indonesia,0,0,0,0,2,10,12,16.666666666666664,-0.789275,113.921327
1998,Iran,0,0,0,0,5,3,8,62.5,32.427908,53.688046
1998,Ireland,0,0,0,0,5,3,8,62.5,53.41291,-8.24389
1998,Israel,0,0,0,0,8,15,23,34.78260869565217,31.046051,34.851612
1998,Japan,0,0,0,0,14,13,27,51.85185185185185,36.204824,138.252924
1998,Kuwait,0,0,0,0,3,1,4,75,29.31166,47.481766
1998,Latvia,0,0,0,0,6,2,8,75,56.879635,24.603189
1998,Mexico,0,0,0,0,9,12,21,42.857142857142854,23.634501,-102.552784
1998,Morocco,0,0,0,0,51,57,108,47.22222222222222,31.791702,-7.09262
1998,New Zealand,0,0,0,0,22,28,50,44,-40.900557,174.885971
1998,Norway,0,0,0,0,5,18,23,21.73913043478261,60.472024,8.468946
1998,Pakistan,0,0,0,0,6,2,8,75,30.375321,69.345116
1998,Paraguay,0,0,0,0,28,24,52,53.84615384615385,-23.442503,-58.443832
1998,Peru,0,0,0,0,5,4,9,55.55555555555556,-9.189967,-75.015152
1998,Philippines,0,0,0,0,2,5,7,28.57142857142857,12.879721,121.774017
1998,Poland,0,0,0,0,3,2,5,60,51.919438,19.145136
1998,Portugal,0,0,0,0,9,6,15,60,39.399872,-8.224454
1998,Qatar,0,0,0,0,4,5,9,44.44444444444444,25.354826,51.183884
1998,Romania,0,0,0,0,42,54,96,43.75,45.943161,24.96676
1998,Senegal,0,0,0,0,4,4,8,50,14.497401,-14.452362
1998,Serbia,0,0,0,0,5,6,11,45.45454545454545,44.016521,21.005859
1998,Slovenia,0,0,0,0,7,3,10,70,46.151241,14.995463
1998,South Africa,0,0,0,0,61,81,142,42.95774647887324,-30.559482,22.937506
1998,South Korea,0,0,0,0,4,4,8,50,35.907757,127.766922
1998,Switzerland,0,0,0,0,38,52,90,42.22222222222222,46.818188,8.227512
1998,Taiwan,0,0,0,0,4,4,8,50,23.69781,120.960515
1998,Thailand,0,0,0,0,7,5,12,58.333333333333336,15.870032,100.992541
1998,Ukraine,0,0,0,0,24,28,52,46.15384615384615,48.379433,31.16558
1998,Uruguay,0,0,0,0,12,21,33,36.36363636363637,-32.522779,-55.765835
1998,Uzbekistan,0,0,0,0,3,8,11,27.27272727272727,41.377491,64.585262
1998,Venezuela,0,0,0,0,9,6,15,60,6.42375,-66.58973
1998,Zimbabwe,0,0,0,0,57,55,112,50.89285714285714,-19.015438,29.154857
1999,Armenia,0,0,0,0,21,23,44,47.72727272727273,40.069099,45.038189
1999,Bahamas,0,0,0,0,3,11,14,21.428571428571427,25.03428,-77.39628
1999,Belarus,0,0,0,0,17,24,41,41.46341463414634,53.709807,27.953389
1999,Belgium,0,0,0,0,21,24,45,46.666666666666664,50.503887,4.469936
1999,Brazil,0,0,0,0,80,62,142,56.33802816901409,-14.235004,-51.92528
1999,Bulgaria,0,0,0,0,10,12,22,45.45454545454545,42.733883,25.48583
1999,Canada,0,0,0,0,34,43,77,44.15584415584416,56.130366,-106.346771
1999,China,0,0,0,0,4,8,12,33.33333333333333,35.86166,104.195397
1999,Colombia,0,0,0,0,3,5,8,37.5,4.570868,-74.297333
1999,Costa Rica,0,0,0,0,22,26,48,45.83333333333333,9.748917,-83.753428
1999,Croatia,0,0,0,0,36,46,82,43.90243902439025,45.1,15.2
1999,Cuba,0,0,0,0,5,3,8,62.5,21.521757,-77.781167
1999,Czech Republic,0,0,0,0,112,141,253,44.26877470355731,49.817492,15.472962
1999,Denmark,0,0,0,0,29,26,55,52.72727272727272,56.26392,9.501785
1999,Dominican Republic,0,0,0,0,3,5,8,37.5,18.735693,-70.162651
1999,Finland,0,0,0,0,6,16,22,27.27272727272727,61.92411,25.748151
1999,Greece,0,0,0,0,4,6,10,40,39.074208,21.824312
1999,Haiti,0,0,0,0,1,7,8,12.5,18.971187,-72.285215
1999,Hungary,0,0,0,0,9,2,11,81.81818181818183,47.162494,19.503304
1999,India,0,0,0,0,8,13,21,38.095238095238095,20.593684,78.96288
1999,Indonesia,0,0,0,0,4,4,8,50,-0.789275,113.921327
1999,Iran,0,0,0,0,2,6,8,25,32.427908,53.688046
1999,Ireland,0,0,0,0,4,4,8,50,53.41291,-8.24389
1999,Israel,0,0,0,0,5,7,12,41.66666666666667,31.046051,34.851612
1999,Italy,0,0,0,0,72,130,202,35.64356435643564,41.87194,12.56738
1999,Japan,0,0,0,0,9,18,27,33.33333333333333,36.204824,138.252924
1999,Kazakhstan,0,0,0,0,3,5,8,37.5,48.019573,66.923684
1999,Latvia,0,0,0,0,5,3,8,62.5,56.879635,24.603189
1999,Mexico,0,0,0,0,6,8,14,42.857142857142854,23.634501,-102.552784
1999,Monaco,0,0,0,0,1,2,3,33.33333333333333,43.750298,7.412841
1999,New Zealand,0,0,0,0,8,15,23,34.78260869565217,-40.900557,174.885971
1999,Norway,0,0,0,0,26,22,48,54.166666666666664,60.472024,8.468946
1999,Pakistan,0,0,0,0,2,5,7,28.57142857142857,30.375321,69.345116
1999,Paraguay,0,0,0,0,16,24,40,40,-23.442503,-58.443832
1999,Peru,0,0,0,0,9,4,13,69.23076923076923,-9.189967,-75.015152
1999,Philippines,0,0,0,0,21,22,43,48.837209302325576,12.879721,121.774017
1999,Poland,0,0,0,0,4,7,11,36.36363636363637,51.919438,19.145136
1999,Portugal,0,0,0,0,4,8,12,33.33333333333333,39.399872,-8.224454
1999,Serbia,0,0,0,0,4,8,12,33.33333333333333,44.016521,21.005859
1999,Slovakia,0,0,0,0,95,80,175,54.285714285714285,48.669026,19.699024
1999,Slovenia,0,0,0,0,6,4,10,60,46.151241,14.995463
1999,South Africa,0,0,0,0,31,39,70,44.285714285714285,-30.559482,22.937506
1999,South Korea,0,0,0,0,6,5,11,54.54545454545454,35.907757,127.766922
1999,Sri Lanka,0,0,0,0,3,5,8,37.5,7.873054,80.771797
1999,Taiwan,0,0,0,0,5,3,8,62.5,23.69781,120.960515
1999,Thailand,0,0,0,0,21,8,29,72.41379310344827,15.870032,100.992541
1999,Togo,0,0,0,0,1,7,8,12.5,8.619543,0.824782
1999,Turkey,0,0,0,0,2,6,8,25,38.963745,35.243322
1999,Ukraine,0,0,0,0,26,27,53,49.056603773584904,48.379433,31.16558
1999,Uruguay,0,0,0,0,10,16,26,38.46153846153847,-32.522779,-55.765835
1999,Uzbekistan,0,0,0,0,3,6,9,33.33333333333333,41.377491,64.585262
1999,Venezuela,0,0,0,0,4,8,12,33.33333333333333,6.42375,-66.58973
2000,Armenia,0,0,0,0,15,26,41,36.58536585365854,40.069099,45.038189
2000,Austria,0,0,0,0,39,59,98,39.795918367346935,47.516231,14.550072
2000,Bahamas,0,0,0,0,2,8,10,20,25.03428,-77.39628
2000,Belarus,0,0,0,0,48,38,86,55.81395348837209,53.709807,27.953389
2000,Belgium,0,0,0,0,35,41,76,46.05263157894737,50.503887,4.469936
2000,Bulgaria,0,0,0,0,10,25,35,28.57142857142857,42.733883,25.48583
2000,Canada,0,0,0,0,16,26,42,38.095238095238095,56.130366,-106.346771
2000,China,0,0,0,0,4,8,12,33.33333333333333,35.86166,104.195397
2000,Colombia,0,0,0,0,3,12,15,20,4.570868,-74.297333
2000,Costa Rica,0,0,0,0,12,26,38,31.57894736842105,9.748917,-83.753428
2000,Croatia,0,0,0,0,44,47,91,48.35164835164835,45.1,15.2
2000,Cuba,0,0,0,0,3,5,8,37.5,21.521757,-77.781167
2000,Czech Republic,0,0,0,0,99,139,238,41.596638655462186,49.817492,15.472962
2000,Denmark,0,0,0,0,6,7,13,46.15384615384615,56.26392,9.501785
2000,Ecuador,0,0,0,0,49,31,80,61.25000000000001,-1.831239,-78.183406
2000,Egypt,0,0,0,0,2,6,8,25,26.820553,30.802498
2000,Estonia,0,0,0,0,5,3,8,62.5,58.595272,25.013607
2000,Finland,0,0,0,0,11,11,22,50,61.92411,25.748151
2000,Greece,0,0,0,0,6,6,12,50,39.074208,21.824312
2000,Guatemala,0,0,0,0,3,5,8,37.5,15.783471,-90.230759
2000,Hungary,0,0,0,0,4,13,17,23.52941176470588,47.162494,19.503304
2000,India,0,0,0,0,9,14,23,39.130434782608695,20.593684,78.96288
2000,Indonesia,0,0,0,0,10,2,12,83.33333333333334,-0.789275,113.921327
2000,Iran,0,0,0,0,4,4,8,50,32.427908,53.688046
2000,Ireland,0,0,0,0,2,6,8,25,53.41291,-8.24389
2000,Israel,0,0,0,0,19,24,43,44.18604651162791,31.046051,34.851612
2000,Italy,0,0,0,0,80,106,186,43.01075268817204,41.87194,12.56738
2000,Japan,0,0,0,0,8,12,20,40,36.204824,138.252924
2000,Kazakhstan,0,0,0,0,3,5,8,37.5,48.019573,66.923684
2000,Latvia,0,0,0,0,1,7,8,12.5,56.879635,24.603189
2000,Lithuania,0,0,0,0,3,5,8,37.5,55.169438,23.881275
2000,Luxembourg,0,0,0,0,5,3,8,62.5,49.815273,6.129583
2000,Malaysia,0,0,0,0,3,5,8,37.5,4.210484,101.975766
2000,Mexico,0,0,0,0,12,2,14,85.71428571428571,23.634501,-102.552784
2000,Monaco,0,0,0,0,1,6,7,14.285714285714285,43.750298,7.412841
2000,Morocco,0,0,0,0,93,85,178,52.24719101123596,31.791702,-7.09262
2000,New Zealand,0,0,0,0,4,5,9,44.44444444444444,-40.900557,174.885971
2000,Norway,0,0,0,0,11,22,33,33.33333333333333,60.472024,8.468946
2000,Pakistan,0,0,0,0,3,5,8,37.5,30.375321,69.345116
2000,Paraguay,0,0,0,0,7,5,12,58.333333333333336,-23.442503,-58.443832
2000,Peru,0,0,0,0,5,3,8,62.5,-9.189967,-75.015152
2000,Philippines,0,0,0,0,12,22,34,35.294117647058826,12.879721,121.774017
2000,Poland,0,0,0,0,4,4,8,50,51.919438,19.145136
2000,Portugal,0,0,0,0,3,7,10,30,39.399872,-8.224454
2000,Romania,0,0,0,0,49,55,104,47.11538461538461,45.943161,24.96676
2000,Serbia,0,0,0,0,2,4,6,33.33333333333333,44.016521,21.005859
2000,Slovenia,0,0,0,0,8,4,12,66.66666666666666,46.151241,14.995463
2000,South Africa,0,0,0,0,48,39,87,55.172413793103445,-30.559482,22.937506
2000,South Korea,0,0,0,0,12,11,23,52.17391304347826,35.907757,127.766922
2000,Taiwan,0,0,0,0,7,5,12,58.333333333333336,23.69781,120.960515
2000,Thailand,0,0,0,0,13,21,34,38.23529411764706,15.870032,100.992541
2000,Turkey,0,0,0,0,4,4,8,50,38.963745,35.243322
2000,Ukraine,0,0,0,0,25,20,45,55.55555555555556,48.379433,31.16558
2000,Uruguay,0,0,0,0,4,6,10,40,-32.522779,-55.765835
2000,Uzbekistan,0,0,0,0,4,4,8,50,41.377491,64.585262
2000,Venezuela,0,0,0,0,8,5,13,61.53846153846154,6.42375,-66.58973
2000,Zimbabwe,0,0,0,0,41,44,85,48.23529411764706,-19.015438,29.154857
2001,Armenia,0,0,0,0,18,25,43,41.86046511627907,40.069099,45.038189
2001,Austria,0,0,0,0,45,53,98,45.91836734693878,47.516231,14.550072
2001,Bahamas,0,0,0,0,2,6,8,25,25.03428,-77.39628
2001,Belarus,0,0,0,0,45,55,100,45,53.709807,27.953389
2001,Belgium,0,0,0,0,65,72,137,47.44525547445255,50.503887,4.469936
2001,Bulgaria,0,0,0,0,1,2,3,33.33333333333333,42.733883,25.48583
2001,Canada,0,0,0,0,10,21,31,32.25806451612903,56.130366,-106.346771
2001,China,0,0,0,0,3,11,14,21.428571428571427,35.86166,104.195397
2001,Colombia,0,0,0,0,8,4,12,66.66666666666666,4.570868,-74.297333
2001,Costa Rica,0,0,0,0,8,11,19,42.10526315789473,9.748917,-83.753428
2001,Croatia,0,0,0,0,60,48,108,55.55555555555556,45.1,15.2
2001,Denmark,0,0,0,0,28,22,50,56.00000000000001,56.26392,9.501785
2001,Dominican Republic,0,0,0,0,4,4,8,50,18.735693,-70.162651
2001,Ecuador,0,0,0,0,31,29,60,51.66666666666667,-1.831239,-78.183406
2001,Estonia,0,0,0,0,2,6,8,25,58.595272,25.013607
2001,Finland,0,0,0,0,9,6,15,60,61.92411,25.748151
2001,Georgia,0,0,0,0,4,7,11,36.36363636363637,42.315407,43.356892
2001,Greece,0,0,0,0,10,3,13,76.92307692307693,39.074208,21.824312
2001,Guatemala,0,0,0,0,2,6,8,25,15.783471,-90.230759
2001,Hungary,0,0,0,0,11,8,19,57.89473684210527,47.162494,19.503304
2001,India,0,0,0,0,5,8,13,38.46153846153847,20.593684,78.96288
2001,Indonesia,0,0,0,0,5,7,12,41.66666666666667,-0.789275,113.921327
2001,Iran,0,0,0,0,2,6,8,25,32.427908,53.688046
2001,Ireland,0,0,0,0,5,3,8,62.5,53.41291,-8.24389
2001,Israel,0,0,0,0,29,39,68,42.64705882352941,31.046051,34.851612
2001,Japan,0,0,0,0,11,16,27,40.74074074074074,36.204824,138.252924
2001,Kuwait,0,0,0,0,4,4,8,50,29.31166,47.481766
2001,Luxembourg,0,0,0,0,5,7,12,41.66666666666667,49.815273,6.129583
2001,Malaysia,0,0,0,0,2,6,8,25,4.210484,101.975766
2001,Mexico,0,0,0,0,4,9,13,30.76923076923077,23.634501,-102.552784
2001,Moldova,0,0,0,0,5,3,8,62.5,47.411631,28.369885
2001,Monaco,0,0,0,0,3,6,9,33.33333333333333,43.750298,7.412841
2001,New Zealand,0,0,0,0,3,6,9,33.33333333333333,-40.900557,174.885971
2001,Norway,0,0,0,0,9,9,18,50,60.472024,8.468946
2001,Pakistan,0,0,0,0,5,3,8,62.5,30.375321,69.345116
2001,Paraguay,0,0,0,0,12,11,23,52.17391304347826,-23.442503,-58.443832
2001,Peru,0,0,0,0,5,8,13,38.46153846153847,-9.189967,-75.015152
2001,Philippines,0,0,0,0,10,20,30,33.33333333333333,12.879721,121.774017
2001,Poland,0,0,0,0,4,5,9,44.44444444444444,51.919438,19.145136
2001,Portugal,0,0,0,0,2,8,10,20,39.399872,-8.224454
2001,Romania,0,0,0,0,45,48,93,48.38709677419355,45.943161,24.96676
2001,Serbia,0,0,0,0,3,13,16,18.75,44.016521,21.005859
2001,Slovakia,0,0,0,0,44,49,93,47.31182795698925,48.669026,19.699024
2001,Slovenia,0,0,0,0,3,7,10,30,46.151241,14.995463
2001,South Africa,0,0,0,0,27,34,61,44.26229508196721,-30.559482,22.937506
2001,South Korea,0,0,0,0,15,25,40,37.5,35.907757,127.766922
2001,Syria,0,0,0,0,2,6,8,25,34.802075,38.996815
2001,Taiwan,0,0,0,0,7,1,8,87.5,23.69781,120.960515
2001,Thailand,0,0,0,0,14,19,33,42.42424242424242,15.870032,100.992541
2001,Turkey,0,0,0,0,1,7,8,12.5,38.963745,35.243322
2001,Ukraine,0,0,0,0,11,22,33,33.33333333333333,48.379433,31.16558
2001,Uruguay,0,0,0,0,8,3,11,72.72727272727273,-32.522779,-55.765835
2001,Uzbekistan,0,0,0,0,4,4,8,50,41.377491,64.585262
2001,Venezuela,0,0,0,0,8,4,12,66.66666666666666,6.42375,-66.58973
2001,Zimbabwe,0,0,0,0,16,27,43,37.2093023255814,-19.015438,29.154857
2002,Armenia,0,0,0,0,13,25,38,34.21052631578947,40.069099,45.038189
2002,Austria,0,0,0,0,47,81,128,36.71875,47.516231,14.550072
2002,Bahamas,0,0,0,0,3,9,12,25,25.03428,-77.39628
2002,Belarus,0,0,0,0,37,38,75,49.333333333333336,53.709807,27.953389
2002,Belgium,0,0,0,0,67,73,140,47.85714285714286,50.503887,4.469936
2002,Bulgaria,0,0,0,0,4,5,9,44.44444444444444,42.733883,25.48583
2002,Canada,0,0,0,0,8,9,17,47.05882352941176,56.130366,-106.346771
2002,China,0,0,0,0,7,5,12,58.333333333333336,35.86166,104.195397
2002,Colombia,0,0,0,0,6,2,8,75,4.570868,-74.297333
2002,Costa Rica,0,0,0,0,4,8,12,33.33333333333333,9.748917,-83.753428
2002,Croatia,0,0,0,0,45,57,102,44.11764705882353,45.1,15.2
2002,Cuba,0,0,0,0,4,4,8,50,21.521757,-77.781167
2002,Czech Republic,0,0,0,0,111,120,231,48.05194805194805,49.817492,15.472962
2002,Denmark,0,0,0,0,37,38,75,49.333333333333336,56.26392,9.501785
2002,Egypt,0,0,0,0,5,3,8,62.5,26.820553,30.802498
2002,Finland,0,0,0,0,30,34,64,46.875,61.92411,25.748151
2002,Georgia,0,0,0,0,10,20,30,33.33333333333333,42.315407,43.356892
2002,Ghana,0,0,0,0,5,3,8,62.5,7.946527,-1.023194
2002,Guatemala,0,0,0,0,3,5,8,37.5,15.783471,-90.230759
2002,Hungary,0,0,0,0,17,27,44,38.63636363636363,47.162494,19.503304
2002,India,0,0,0,0,7,8,15,46.666666666666664,20.593684,78.96288
2002,Indonesia,0,0,0,0,5,3,8,62.5,-0.789275,113.921327
2002,Ireland,0,0,0,0,3,3,6,50,53.41291,-8.24389
2002,Israel,0,0,0,0,19,31,50,38,31.046051,34.851612
2002,Italy,0,0,0,0,47,81,128,36.71875,41.87194,12.56738
2002,Japan,0,0,0,0,7,14,21,33.33333333333333,36.204824,138.252924
2002,Kazakhstan,0,0,0,0,5,3,8,62.5,48.019573,66.923684
2002,Kuwait,0,0,0,0,3,5,8,37.5,29.31166,47.481766
2002,Latvia,0,0,0,0,1,7,8,12.5,56.879635,24.603189
2002,Luxembourg,0,0,0,0,8,5,13,61.53846153846154,49.815273,6.129583
2002,Malaysia,0,0,0,0,1,7,8,12.5,4.210484,101.975766
2002,Mexico,0,0,0,0,4,9,13,30.76923076923077,23.634501,-102.552784
2002,Monaco,0,0,0,0,5,5,10,50,43.750298,7.412841
2002,New Zealand,0,0,0,0,4,7,11,36.36363636363637,-40.900557,174.885971
2002,Norway,0,0,0,0,8,5,13,61.53846153846154,60.472024,8.468946
2002,Pakistan,0,0,0,0,8,4,12,66.66666666666666,30.375321,69.345116
2002,Paraguay,0,0,0,0,14,22,36,38.88888888888889,-23.442503,-58.443832
2002,Peru,0,0,0,0,15,13,28,53.57142857142857,-9.189967,-75.015152
2002,Philippines,0,0,0,0,11,20,31,35.483870967741936,12.879721,121.774017
2002,Portugal,0,0,0,0,2,11,13,15.384615384615385,39.399872,-8.224454
2002,Romania,0,0,0,0,68,54,122,55.73770491803278,45.943161,24.96676
2002,Serbia,0,0,0,0,4,4,8,50,44.016521,21.005859
2002,Slovakia,0,0,0,0,43,54,97,44.329896907216494,48.669026,19.699024
2002,Slovenia,0,0,0,0,8,4,12,66.66666666666666,46.151241,14.995463
2002,South Africa,0,0,0,0,29,33,62,46.774193548387096,-30.559482,22.937506
2002,South Korea,0,0,0,0,17,20,37,45.94594594594595,35.907757,127.766922
2002,Taiwan,0,0,0,0,4,4,8,50,23.69781,120.960515
2002,Ukraine,0,0,0,0,5,3,8,62.5,48.379433,31.16558
2002,Uruguay,0,0,0,0,6,6,12,50,-32.522779,-55.765835
2002,Uzbekistan,0,0,0,0,5,7,12,41.66666666666667,41.377491,64.585262
2002,Venezuela,0,0,0,0,5,7,12,41.66666666666667,6.42375,-66.58973
2002,Zimbabwe,0,0,0,0,8,11,19,42.10526315789473,-19.015438,29.154857
2003,Andorra,0,0,0,0,3,5,8,37.5,42.546245,1.601554
2003,Armenia,0,0,0,0,28,26,54,51.85185185185185,40.069099,45.038189
2003,Belarus,0,0,0,0,54,49,103,52.42718446601942,53.709807,27.953389
2003,Belgium,0,0,0,0,65,92,157,41.40127388535032,50.503887,4.469936
2003,Bosnia and Herzegovina,0,0,0,0,1,3,4,25,43.915886,17.679076
2003,Bulgaria,0,0,0,0,3,5,8,37.5,42.733883,25.48583
2003,Canada,0,0,0,0,11,10,21,52.38095238095239,56.130366,-106.346771
2003,China,0,0,0,0,4,4,8,50,35.86166,104.195397
2003,Colombia,0,0,0,0,2,7,9,22.22222222222222,4.570868,-74.297333
2003,Costa Rica,0,0,0,0,1,3,4,25,9.748917,-83.753428
2003,Croatia,0,0,0,0,57,75,132,43.18181818181818,45.1,15.2
2003,Cuba,0,0,0,0,5,3,8,62.5,21.521757,-77.781167
2003,Denmark,0,0,0,0,23,33,56,41.07142857142857,56.26392,9.501785
2003,Dominican Republic,0,0,0,0,7,5,12,58.333333333333336,18.735693,-70.162651
2003,Ecuador,0,0,0,0,28,29,57,49.122807017543856,-1.831239,-78.183406
2003,Egypt,0,0,0,0,3,5,8,37.5,26.820553,30.802498
2003,Finland,0,0,0,0,43,33,76,56.57894736842105,61.92411,25.748151
2003,Georgia,0,0,0,0,6,17,23,26.08695652173913,42.315407,43.356892
2003,Ghana,0,0,0,0,2,6,8,25,7.946527,-1.023194
2003,Greece,0,0,0,0,9,4,13,69.23076923076923,39.074208,21.824312
2003,Haiti,0,0,0,0,2,6,8,25,18.971187,-72.285215
2003,Hungary,0,0,0,0,5,11,16,31.25,47.162494,19.503304
2003,India,0,0,0,0,9,14,23,39.130434782608695,20.593684,78.96288
2003,Indonesia,0,0,0,0,3,5,8,37.5,-0.789275,113.921327
2003,Iran,0,0,0,0,6,2,8,75,32.427908,53.688046
2003,Ireland,0,0,0,0,3,5,8,37.5,53.41291,-8.24389
2003,Israel,0,0,0,0,11,16,27,40.74074074074074,31.046051,34.851612
2003,Italy,0,0,0,0,46,73,119,38.655462184873954,41.87194,12.56738
2003,Japan,0,0,0,0,12,12,24,50,36.204824,138.252924
2003,Kazakhstan,0,0,0,0,3,5,8,37.5,48.019573,66.923684
2003,Luxembourg,0,0,0,0,5,4,9,55.55555555555556,49.815273,6.129583
2003,Mexico,0,0,0,0,5,4,9,55.55555555555556,23.634501,-102.552784
2003,Monaco,0,0,0,0,17,26,43,39.53488372093023,43.750298,7.412841
2003,Morocco,0,0,0,0,65,52,117,55.55555555555556,31.791702,-7.09262
2003,New Zealand,0,0,0,0,5,5,10,50,-40.900557,174.885971
2003,Norway,0,0,0,0,1,13,14,7.142857142857142,60.472024,8.468946
2003,Pakistan,0,0,0,0,2,10,12,16.666666666666664,30.375321,69.345116
2003,Paraguay,0,0,0,0,14,8,22,63.63636363636363,-23.442503,-58.443832
2003,Peru,0,0,0,0,28,33,61,45.90163934426229,-9.189967,-75.015152
2003,Philippines,0,0,0,0,10,25,35,28.57142857142857,12.879721,121.774017
2003,Poland,0,0,0,0,6,6,12,50,51.919438,19.145136
2003,Portugal,0,0,0,0,4,8,12,33.33333333333333,39.399872,-8.224454
2003,Romania,0,0,0,0,37,51,88,42.04545454545455,45.943161,24.96676
2003,Serbia,0,0,0,0,11,10,21,52.38095238095239,44.016521,21.005859
2003,Slovenia,0,0,0,0,4,4,8,50,46.151241,14.995463
2003,South Africa,0,0,0,0,41,34,75,54.666666666666664,-30.559482,22.937506
2003,South Korea,0,0,0,0,22,31,53,41.509433962264154,35.907757,127.766922
2003,Sweden,0,0,0,0,79,96,175,45.14285714285714,60.128161,18.643501
2003,Taiwan,0,0,0,0,8,4,12,66.66666666666666,23.69781,120.960515
2003,Tajikistan,0,0,0,0,1,7,8,12.5,38.861034,71.276093
2003,Tunisia,0,0,0,0,4,4,8,50,33.886917,9.537499
2003,Ukraine,0,0,0,0,4,4,8,50,48.379433,31.16558
2003,United Kingdom,0,0,0,0,48,47,95,50.526315789473685,55.378051,-3.435973
2003,Uruguay,0,0,0,0,3,5,8,37.5,-32.522779,-55.765835
2003,Uzbekistan,0,0,0,0,2,2,4,50,41.377491,64.585262
2003,Venezuela,0,0,0,0,7,4,11,63.63636363636363,6.42375,-66.58973
2003,Zimbabwe,0,0,0,0,5,13,18,27.77777777777778,-19.015438,29.154857
2004,Algeria,0,0,0,0,1,4,5,20,28.033886,1.659626
2004,Armenia,0,0,0,0,17,27,44,38.63636363636363,40.069099,45.038189
2004,Austria,0,0,0,0,61,76,137,44.52554744525548,47.516231,14.550072
2004,Bahamas,0,0,0,0,2,4,6,33.33333333333333,25.03428,-77.39628
2004,Belarus,0,0,0,0,32,34,66,48.484848484848484,53.709807,27.953389
2004,Belgium,0,0,0,0,68,102,170,40,50.503887,4.469936
2004,Bosnia and Herzegovina,0,0,0,0,2,5,7,28.57142857142857,43.915886,17.679076
2004,Bulgaria,0,0,0,0,4,4,8,50,42.733883,25.48583
2004,Canada,0,0,0,0,4,17,21,19.047619047619047,56.130366,-106.346771
2004,China,0,0,0,0,11,8,19,57.89473684210527,35.86166,104.195397
2004,Colombia,0,0,0,0,5,7,12,41.66666666666667,4.570868,-74.297333
2004,Croatia,0,0,0,0,87,90,177,49.152542372881356,45.1,15.2
2004,Cuba,0,0,0,0,2,6,8,25,21.521757,-77.781167
2004,Cyprus,0,0,0,0,2,2,4,50,35.126413,33.429859
2004,Denmark,0,0,0,0,18,28,46,39.130434782608695,56.26392,9.501785
2004,Dominican Republic,0,0,0,0,7,5,12,58.333333333333336,18.735693,-70.162651
2004,Ecuador,0,0,0,0,10,24,34,29.411764705882355,-1.831239,-78.183406
2004,Egypt,0,0,0,0,2,6,8,25,26.820553,30.802498
2004,Finland,0,0,0,0,22,23,45,48.888888888888886,61.92411,25.748151
2004,Georgia,0,0,0,0,17,25,42,40.476190476190474,42.315407,43.356892
2004,Greece,0,0,0,0,3,7,10,30,39.074208,21.824312
2004,Haiti,0,0,0,0,3,5,8,37.5,18.971187,-72.285215
2004,Hungary,0,0,0,0,5,7,12,41.66666666666667,47.162494,19.503304
2004,India,0,0,0,0,4,10,14,28.57142857142857,20.593684,78.96288
2004,Indonesia,0,0,0,0,6,2,8,75,-0.789275,113.921327
2004,Iran,0,0,0,0,6,2,8,75,32.427908,53.688046
2004,Ireland,0,0,0,0,2,6,8,25,53.41291,-8.24389
2004,Israel,0,0,0,0,11,27,38,28.947368421052634,31.046051,34.851612
2004,Jamaica,0,0,0,0,3,5,8,37.5,18.109581,-77.297508
2004,Japan,0,0,0,0,9,15,24,37.5,36.204824,138.252924
2004,Kazakhstan,0,0,0,0,1,1,2,50,48.019573,66.923684
2004,Kuwait,0,0,0,0,3,5,8,37.5,29.31166,47.481766
2004,Latvia,0,0,0,0,2,6,8,25,56.879635,24.603189
2004,Luxembourg,0,0,0,0,14,12,26,53.84615384615385,49.815273,6.129583
2004,Mexico,0,0,0,0,11,3,14,78.57142857142857,23.634501,-102.552784
2004,Monaco,0,0,0,0,4,13,17,23.52941176470588,43.750298,7.412841
2004,Morocco,0,0,0,0,16,33,49,32.6530612244898,31.791702,-7.09262
2004,New Zealand,0,0,0,0,4,10,14,28.57142857142857,-40.900557,174.885971
2004,Norway,0,0,0,0,5,6,11,45.45454545454545,60.472024,8.468946
2004,Pakistan,0,0,0,0,2,11,13,15.384615384615385,30.375321,69.345116
2004,Paraguay,0,0,0,0,6,7,13,46.15384615384615,-23.442503,-58.443832
2004,Peru,0,0,0,0,35,38,73,47.94520547945205,-9.189967,-75.015152
2004,Philippines,0,0,0,0,5,9,14,35.714285714285715,12.879721,121.774017
2004,Poland,0,0,0,0,7,10,17,41.17647058823529,51.919438,19.145136
2004,Portugal,0,0,0,0,3,8,11,27.27272727272727,39.399872,-8.224454
2004,Romania,0,0,0,0,54,53,107,50.467289719626166,45.943161,24.96676
2004,Serbia,0,0,0,0,15,14,29,51.724137931034484,44.016521,21.005859
2004,Slovenia,0,0,0,0,2,2,4,50,46.151241,14.995463
2004,South Africa,0,0,0,0,27,37,64,42.1875,-30.559482,22.937506
2004,South Korea,0,0,0,0,26,19,45,57.77777777777777,35.907757,127.766922
2004,Switzerland,0,0,0,0,95,57,152,62.5,46.818188,8.227512
2004,Taiwan,0,0,0,0,10,16,26,38.46153846153847,23.69781,120.960515
2004,Tunisia,0,0,0,0,4,4,8,50,33.886917,9.537499
2004,Ukraine,0,0,0,0,5,4,9,55.55555555555556,48.379433,31.16558
2004,Uruguay,0,0,0,0,4,4,8,50,-32.522779,-55.765835
2004,Uzbekistan,0,0,0,0,3,3,6,50,41.377491,64.585262
2004,Venezuela,0,0,0,0,3,5,8,37.5,6.42375,-66.58973
2004,Zimbabwe,0,0,0,0,3,5,8,37.5,-19.015438,29.154857
2005,Algeria,0,0,0,0,4,4,8,50,28.033886,1.659626
2005,Armenia,0,0,0,0,3,9,12,25,40.069099,45.038189
2005,Austria,0,0,0,0,38,56,94,40.42553191489361,47.516231,14.550072
2005,Bahamas,0,0,0,0,1,4,5,20,25.03428,-77.39628
2005,Belarus,0,0,0,0,36,30,66,54.54545454545454,53.709807,27.953389
2005,Bosnia and Herzegovina,0,0,0,0,1,4,5,20,43.915886,17.679076
2005,Brazil,0,0,0,0,29,43,72,40.27777777777778,-14.235004,-51.92528
2005,Bulgaria,0,0,0,0,6,6,12,50,42.733883,25.48583
2005,Canada,0,0,0,0,6,13,19,31.57894736842105,56.130366,-106.346771
2005,China,0,0,0,0,5,9,14,35.714285714285715,35.86166,104.195397
2005,Colombia,0,0,0,0,4,6,10,40,4.570868,-74.297333
2005,Costa Rica,0,0,0,0,3,5,8,37.5,9.748917,-83.753428
2005,Cuba,0,0,0,0,1,6,7,14.285714285714285,21.521757,-77.781167
2005,Cyprus,0,0,0,0,11,12,23,47.82608695652174,35.126413,33.429859
2005,Denmark,0,0,0,0,17,27,44,38.63636363636363,56.26392,9.501785
2005,Dominican Republic,0,0,0,0,3,5,8,37.5,18.735693,-70.162651
2005,Ecuador,0,0,0,0,22,26,48,45.83333333333333,-1.831239,-78.183406
2005,Estonia,0,0,0,0,1,7,8,12.5,58.595272,25.013607
2005,Finland,0,0,0,0,35,25,60,58.333333333333336,61.92411,25.748151
2005,Georgia,0,0,0,0,7,16,23,30.434782608695656,42.315407,43.356892
2005,Ghana,0,0,0,0,2,5,7,28.57142857142857,7.946527,-1.023194
2005,Greece,0,0,0,0,5,3,8,62.5,39.074208,21.824312
2005,Hungary,0,0,0,0,5,3,8,62.5,47.162494,19.503304
2005,India,0,0,0,0,8,9,17,47.05882352941176,20.593684,78.96288
2005,Indonesia,0,0,0,0,2,10,12,16.666666666666664,-0.789275,113.921327
2005,Iran,0,0,0,0,3,5,8,37.5,32.427908,53.688046
2005,Israel,0,0,0,0,11,15,26,42.30769230769231,31.046051,34.851612
2005,Italy,0,0,0,0,106,125,231,45.887445887445885,41.87194,12.56738
2005,Jamaica,0,0,0,0,5,2,7,71.42857142857143,18.109581,-77.297508
2005,Japan,0,0,0,0,7,13,20,35,36.204824,138.252924
2005,Kazakhstan,0,0,0,0,3,8,11,27.27272727272727,48.019573,66.923684
2005,Kuwait,0,0,0,0,5,3,8,62.5,29.31166,47.481766
2005,Latvia,0,0,0,0,3,5,8,37.5,56.879635,24.603189
2005,Luxembourg,0,0,0,0,22,27,49,44.89795918367347,49.815273,6.129583
2005,Mexico,0,0,0,0,6,4,10,60,23.634501,-102.552784
2005,Monaco,0,0,0,0,11,25,36,30.555555555555557,43.750298,7.412841
2005,Morocco,0,0,0,0,8,18,26,30.76923076923077,31.791702,-7.09262
2005,Netherlands,0,0,0,0,26,49,75,34.66666666666667,52.132633,5.291266
2005,New Zealand,0,0,0,0,7,7,14,50,-40.900557,174.885971
2005,Norway,0,0,0,0,4,4,8,50,60.472024,8.468946
2005,Pakistan,0,0,0,0,5,7,12,41.66666666666667,30.375321,69.345116
2005,Paraguay,0,0,0,0,2,14,16,12.5,-23.442503,-58.443832
2005,Peru,0,0,0,0,21,27,48,43.75,-9.189967,-75.015152
2005,Philippines,0,0,0,0,6,7,13,46.15384615384615,12.879721,121.774017
2005,Poland,0,0,0,0,7,7,14,50,51.919438,19.145136
2005,Portugal,0,0,0,0,8,5,13,61.53846153846154,39.399872,-8.224454
2005,Romania,0,0,0,0,55,65,120,45.83333333333333,45.943161,24.96676
2005,Samoa,0,0,0,0,1,1,2,50,-13.759029,-172.104629
2005,Serbia,0,0,0,0,27,30,57,47.368421052631575,44.016521,21.005859
2005,Slovakia,0,0,0,0,73,66,139,52.51798561151079,48.669026,19.699024
2005,Slovenia,0,0,0,0,9,4,13,69.23076923076923,46.151241,14.995463
2005,Solomon Islands,0,0,0,0,2,2,4,50,-9.64571,160.156194
2005,South Africa,0,0,0,0,17,18,35,48.57142857142857,-30.559482,22.937506
2005,South Korea,0,0,0,0,18,23,41,43.90243902439025,35.907757,127.766922
2005,Sweden,0,0,0,0,111,95,206,53.883495145631066,60.128161,18.643501
2005,Taiwan,0,0,0,0,10,21,31,32.25806451612903,23.69781,120.960515
2005,Thailand,0,0,0,0,40,38,78,51.28205128205128,15.870032,100.992541
2005,Ukraine,0,0,0,0,11,6,17,64.70588235294117,48.379433,31.16558
2005,Uruguay,0,0,0,0,8,4,12,66.66666666666666,-32.522779,-55.765835
2005,Uzbekistan,0,0,0,0,3,5,8,37.5,41.377491,64.585262
2005,Venezuela,0,0,0,0,3,5,8,37.5,6.42375,-66.58973
2005,Zimbabwe,0,0,0,0,1,6,7,14.285714285714285,-19.015438,29.154857
2006,Algeria,0,0,0,0,4,7,11,36.36363636363637,28.033886,1.659626
2006,Belarus,0,0,0,0,24,29,53,45.28301886792453,53.709807,27.953389
2006,Bolivia,0,0,0,0,1,7,8,12.5,-16.290154,-63.588653
2006,Bosnia and Herzegovina,0,0,0,0,1,3,4,25,43.915886,17.679076
2006,Brazil,0,0,0,0,21,45,66,31.818181818181817,-14.235004,-51.92528
2006,Bulgaria,0,0,0,0,4,4,8,50,42.733883,25.48583
2006,Canada,0,0,0,0,8,19,27,29.629629629629626,56.130366,-106.346771
2006,China,0,0,0,0,4,8,12,33.33333333333333,35.86166,104.195397
2006,Colombia,0,0,0,0,14,10,24,58.333333333333336,4.570868,-74.297333
2006,Costa Rica,0,0,0,0,4,12,16,25,9.748917,-83.753428
2006,Denmark,0,0,0,0,20,28,48,41.66666666666667,56.26392,9.501785
2006,Dominican Republic,0,0,0,0,6,6,12,50,18.735693,-70.162651
2006,Ecuador,0,0,0,0,13,20,33,39.39393939393939,-1.831239,-78.183406
2006,Egypt,0,0,0,0,2,6,8,25,26.820553,30.802498
2006,Georgia,0,0,0,0,10,6,16,62.5,42.315407,43.356892
2006,Greece,0,0,0,0,4,8,12,33.33333333333333,39.074208,21.824312
2006,Guatemala,0,0,0,0,4,4,8,50,15.783471,-90.230759
2006,Hungary,0,0,0,0,8,4,12,66.66666666666666,47.162494,19.503304
2006,India,0,0,0,0,4,15,19,21.052631578947366,20.593684,78.96288
2006,Indonesia,0,0,0,0,9,3,12,75,-0.789275,113.921327
2006,Ireland,0,0,0,0,3,5,8,37.5,53.41291,-8.24389
2006,Israel,0,0,0,0,3,10,13,23.076923076923077,31.046051,34.851612
2006,Jamaica,0,0,0,0,2,6,8,25,18.109581,-77.297508
2006,Japan,0,0,0,0,12,12,24,50,36.204824,138.252924
2006,Kazakhstan,0,0,0,0,16,14,30,53.333333333333336,48.019573,66.923684
2006,Kuwait,0,0,0,0,7,4,11,63.63636363636363,29.31166,47.481766
2006,Latvia,0,0,0,0,5,7,12,41.66666666666667,56.879635,24.603189
2006,Luxembourg,0,0,0,0,14,25,39,35.8974358974359,49.815273,6.129583
2006,Malaysia,0,0,0,0,1,6,7,14.285714285714285,4.210484,101.975766
2006,Marshall Islands,0,0,0,0,1,1,2,50,7.131474,171.184478
2006,Mexico,0,0,0,0,7,8,15,46.666666666666664,23.634501,-102.552784
2006,Monaco,0,0,0,0,4,7,11,36.36363636363637,43.750298,7.412841
2006,Morocco,0,0,0,0,5,10,15,33.33333333333333,31.791702,-7.09262
2006,Netherlands,0,0,0,0,11,32,43,25.581395348837212,52.132633,5.291266
2006,New Zealand,0,0,0,0,6,5,11,54.54545454545454,-40.900557,174.885971
2006,Norway,0,0,0,0,6,2,8,75,60.472024,8.468946
2006,Pakistan,0,0,0,0,3,10,13,23.076923076923077,30.375321,69.345116
2006,Paraguay,0,0,0,0,10,13,23,43.47826086956522,-23.442503,-58.443832
2006,Peru,0,0,0,0,22,25,47,46.808510638297875,-9.189967,-75.015152
2006,Poland,0,0,0,0,10,13,23,43.47826086956522,51.919438,19.145136
2006,Portugal,0,0,0,0,5,7,12,41.66666666666667,39.399872,-8.224454
2006,Romania,0,0,0,0,21,48,69,30.434782608695656,45.943161,24.96676
2006,Samoa,0,0,0,0,1,1,2,50,-13.759029,-172.104629
2006,Slovakia,0,0,0,0,35,35,70,50,48.669026,19.699024
2006,Slovenia,0,0,0,0,6,4,10,60,46.151241,14.995463
2006,Solomon Islands,0,0,0,0,2,1,3,66.66666666666666,-9.64571,160.156194
2006,South Africa,0,0,0,0,19,33,52,36.53846153846153,-30.559482,22.937506
2006,South Korea,0,0,0,0,26,19,45,57.77777777777777,35.907757,127.766922
2006,Sweden,0,0,0,0,65,75,140,46.42857142857143,60.128161,18.643501
2006,Taiwan,0,0,0,0,13,27,40,32.5,23.69781,120.960515
2006,Thailand,0,0,0,0,39,50,89,43.82022471910113,15.870032,100.992541
2006,Ukraine,0,0,0,0,3,9,12,25,48.379433,31.16558
2006,Uruguay,0,0,0,0,5,3,8,62.5,-32.522779,-55.765835
2006,Uzbekistan,0,0,0,0,4,4,8,50,41.377491,64.585262
2006,Venezuela,0,0,0,0,7,6,13,53.84615384615385,6.42375,-66.58973
2006,Zimbabwe,0,0,0,0,1,6,7,14.285714285714285,-19.015438,29.154857
2007,Algeria,0,0,0,0,4,6,10,40,28.033886,1.659626
2007,Austria,0,0,0,0,61,89,150,40.666666666666664,47.516231,14.550072
2007,Belarus,0,0,0,0,10,25,35,28.57142857142857,53.709807,27.953389
2007,Bosnia and Herzegovina,0,0,0,0,9,24,33,27.27272727272727,43.915886,17.679076
2007,Brazil,0,0,0,0,16,27,43,37.2093023255814,-14.235004,-51.92528
2007,Bulgaria,0,0,0,0,2,6,8,25,42.733883,25.48583
2007,Canada,0,0,0,0,22,27,49,44.89795918367347,56.130366,-106.346771
2007,China,0,0,0,0,3,12,15,20,35.86166,104.195397
2007,Colombia,0,0,0,0,16,24,40,40,4.570868,-74.297333
2007,Cuba,0,0,0,0,1,7,8,12.5,21.521757,-77.781167
2007,Denmark,0,0,0,0,7,23,30,23.333333333333332,56.26392,9.501785
2007,Dominican Republic,0,0,0,0,4,4,8,50,18.735693,-70.162651
2007,Ecuador,0,0,0,0,14,18,32,43.75,-1.831239,-78.183406
2007,El Salvador,0,0,0,0,4,4,8,50,13.794185,-88.89653
2007,Estonia,0,0,0,0,2,5,7,28.57142857142857,58.595272,25.013607
2007,Finland,0,0,0,0,35,30,65,53.84615384615385,61.92411,25.748151
2007,Georgia,0,0,0,0,2,6,8,25,42.315407,43.356892
2007,Greece,0,0,0,0,4,12,16,25,39.074208,21.824312
2007,Hungary,0,0,0,0,3,5,8,37.5,47.162494,19.503304
2007,India,0,0,0,0,5,16,21,23.809523809523807,20.593684,78.96288
2007,Indonesia,0,0,0,0,3,5,8,37.5,-0.789275,113.921327
2007,Iran,0,0,0,0,2,6,8,25,32.427908,53.688046
2007,Israel,0,0,0,0,13,9,22,59.09090909090909,31.046051,34.851612
2007,Italy,0,0,0,0,105,143,248,42.33870967741936,41.87194,12.56738
2007,Japan,0,0,0,0,12,16,28,42.857142857142854,36.204824,138.252924
2007,Kazakhstan,0,0,0,0,30,36,66,45.45454545454545,48.019573,66.923684
2007,Kuwait,0,0,0,0,6,7,13,46.15384615384615,29.31166,47.481766
2007,Latvia,0,0,0,0,15,17,32,46.875,56.879635,24.603189
2007,Luxembourg,0,0,0,0,4,13,17,23.52941176470588,49.815273,6.129583
2007,Marshall Islands,0,0,0,0,1,1,2,50,7.131474,171.184478
2007,Mexico,0,0,0,0,6,5,11,54.54545454545454,23.634501,-102.552784
2007,Monaco,0,0,0,0,8,5,13,61.53846153846154,43.750298,7.412841
2007,Morocco,0,0,0,0,9,8,17,52.94117647058824,31.791702,-7.09262
2007,Netherlands,0,0,0,0,24,36,60,40,52.132633,5.291266
2007,New Zealand,0,0,0,0,5,4,9,55.55555555555556,-40.900557,174.885971
2007,Norway,0,0,0,0,2,7,9,22.22222222222222,60.472024,8.468946
2007,Pakistan,0,0,0,0,6,10,16,37.5,30.375321,69.345116
2007,Paraguay,0,0,0,0,7,3,10,70,-23.442503,-58.443832
2007,Peru,0,0,0,0,25,20,45,55.55555555555556,-9.189967,-75.015152
2007,Philippines,0,0,0,0,10,2,12,83.33333333333334,12.879721,121.774017
2007,Poland,0,0,0,0,12,8,20,60,51.919438,19.145136
2007,Portugal,0,0,0,0,3,9,12,25,39.399872,-8.224454
2007,Romania,0,0,0,0,22,26,48,45.83333333333333,45.943161,24.96676
2007,Slovakia,0,0,0,0,16,26,42,38.095238095238095,48.669026,19.699024
2007,Slovenia,0,0,0,0,5,5,10,50,46.151241,14.995463
2007,Solomon Islands,0,0,0,0,2,1,3,66.66666666666666,-9.64571,160.156194
2007,South Africa,0,0,0,0,11,16,27,40.74074074074074,-30.559482,22.937506
2007,South Korea,0,0,0,0,31,29,60,51.66666666666667,35.907757,127.766922
2007,Sweden,0,0,0,0,79,76,155,50.967741935483865,60.128161,18.643501
2007,Taiwan,0,0,0,0,13,21,34,38.23529411764706,23.69781,120.960515
2007,Thailand,0,0,0,0,11,31,42,26.190476190476193,15.870032,100.992541
2007,Ukraine,0,0,0,0,5,6,11,45.45454545454545,48.379433,31.16558
2007,Uruguay,0,0,0,0,10,1,11,90.9090909090909,-32.522779,-55.765835
2007,Uzbekistan,0,0,0,0,4,5,9,44.44444444444444,41.377491,64.585262
2007,Venezuela,0,0,0,0,2,10,12,16.666666666666664,6.42375,-66.58973
2008,Algeria,0,0,0,0,4,6,10,40,28.033886,1.659626
2008,Australia,0,0,0,0,50,65,115,43.47826086956522,-25.274398,133.775136
2008,Austria,0,0,0,0,41,62,103,39.80582524271845,47.516231,14.550072
2008,Bahamas,0,0,0,0,3,6,9,33.33333333333333,25.03428,-77.39628
2008,Belarus,0,0,0,0,6,14,20,30,53.709807,27.953389
2008,Bolivia,0,0,0,0,2,6,8,25,-16.290154,-63.588653
2008,Bosnia and Herzegovina,0,0,0,0,8,7,15,53.333333333333336,43.915886,17.679076
2008,Brazil,0,0,0,0,14,38,52,26.923076923076923,-14.235004,-51.92528
2008,Canada,0,0,0,0,19,36,55,34.54545454545455,56.130366,-106.346771
2008,China,0,0,0,0,9,9,18,50,35.86166,104.195397
2008,Colombia,0,0,0,0,12,22,34,35.294117647058826,4.570868,-74.297333
2008,Cyprus,0,0,0,0,14,18,32,43.75,35.126413,33.429859
2008,Denmark,0,0,0,0,4,8,12,33.33333333333333,56.26392,9.501785
2008,Dominican Republic,0,0,0,0,5,4,9,55.55555555555556,18.735693,-70.162651
2008,Ecuador,0,0,0,0,22,22,44,50,-1.831239,-78.183406
2008,Egypt,0,0,0,0,3,5,8,37.5,26.820553,30.802498
2008,El Salvador,0,0,0,0,3,7,10,30,13.794185,-88.89653
2008,Finland,0,0,0,0,27,32,59,45.76271186440678,61.92411,25.748151
2008,Georgia,0,0,0,0,1,6,7,14.285714285714285,42.315407,43.356892
2008,Greece,0,0,0,0,1,8,9,11.11111111111111,39.074208,21.824312
2008,Hungary,0,0,0,0,5,3,8,62.5,47.162494,19.503304
2008,India,0,0,0,0,13,15,28,46.42857142857143,20.593684,78.96288
2008,Indonesia,0,0,0,0,3,5,8,37.5,-0.789275,113.921327
2008,Ireland,0,0,0,0,5,3,8,62.5,53.41291,-8.24389
2008,Israel,0,0,0,0,18,30,48,37.5,31.046051,34.851612
2008,Italy,0,0,0,0,114,147,261,43.67816091954023,41.87194,12.56738
2008,Japan,0,0,0,0,25,22,47,53.191489361702125,36.204824,138.252924
2008,Kazakhstan,0,0,0,0,30,38,68,44.11764705882353,48.019573,66.923684
2008,Kuwait,0,0,0,0,3,6,9,33.33333333333333,29.31166,47.481766
2008,Latvia,0,0,0,0,26,27,53,49.056603773584904,56.879635,24.603189
2008,Luxembourg,0,0,0,0,7,12,19,36.84210526315789,49.815273,6.129583
2008,Mexico,0,0,0,0,2,9,11,18.181818181818183,23.634501,-102.552784
2008,Monaco,0,0,0,0,8,6,14,57.14285714285714,43.750298,7.412841
2008,Morocco,0,0,0,0,7,8,15,46.666666666666664,31.791702,-7.09262
2008,Netherlands,0,0,0,0,20,26,46,43.47826086956522,52.132633,5.291266
2008,New Zealand,0,0,0,0,10,5,15,66.66666666666666,-40.900557,174.885971
2008,Oman,0,0,0,0,2,6,8,25,21.512583,55.923255
2008,Pakistan,0,0,0,0,1,4,5,20,30.375321,69.345116
2008,Paraguay,0,0,0,0,9,5,14,64.28571428571429,-23.442503,-58.443832
2008,Peru,0,0,0,0,9,23,32,28.125,-9.189967,-75.015152
2008,Philippines,0,0,0,0,3,11,14,21.428571428571427,12.879721,121.774017
2008,Poland,0,0,0,0,4,10,14,28.57142857142857,51.919438,19.145136
2008,Portugal,0,0,0,0,12,13,25,48,39.399872,-8.224454
2008,Romania,0,0,0,0,27,34,61,44.26229508196721,45.943161,24.96676
2008,Samoa,0,0,0,0,1,3,4,25,-13.759029,-172.104629
2008,Slovakia,0,0,0,0,8,17,25,32,48.669026,19.699024
2008,Slovenia,0,0,0,0,11,7,18,61.111111111111114,46.151241,14.995463
2008,Solomon Islands,0,0,0,0,2,2,4,50,-9.64571,160.156194
2008,South Africa,0,0,0,0,21,19,40,52.5,-30.559482,22.937506
2008,South Korea,0,0,0,0,14,26,40,35,35.907757,127.766922
2008,Taiwan,0,0,0,0,13,18,31,41.935483870967744,23.69781,120.960515
2008,Thailand,0,0,0,0,2,8,10,20,15.870032,100.992541
2008,Tunisia,0,0,0,0,1,7,8,12.5,33.886917,9.537499
2008,Ukraine,0,0,0,0,15,6,21,71.42857142857143,48.379433,31.16558
2008,Uruguay,0,0,0,0,12,17,29,41.37931034482759,-32.522779,-55.765835
2008,Uzbekistan,0,0,0,0,6,6,12,50,41.377491,64.585262
2008,Venezuela,0,0,0,0,4,4,8,50,6.42375,-66.58973
2009,Algeria,0,0,0,0,1,10,11,9.090909090909092,28.033886,1.659626
2009,Austria,0,0,0,0,55,66,121,45.45454545454545,47.516231,14.550072
2009,Bahamas,0,0,0,0,3,5,8,37.5,25.03428,-77.39628
2009,Belarus,0,0,0,0,3,5,8,37.5,53.709807,27.953389
2009,Belgium,0,0,0,0,51,74,125,40.8,50.503887,4.469936
2009,Bosnia and Herzegovina,0,0,0,0,3,5,8,37.5,43.915886,17.679076
2009,Bulgaria,0,0,0,0,6,10,16,37.5,42.733883,25.48583
2009,Canada,0,0,0,0,21,31,52,40.38461538461539,56.130366,-106.346771
2009,Chile,0,0,0,0,57,46,103,55.33980582524271,-35.675147,-71.542969
2009,China,0,0,0,0,5,10,15,33.33333333333333,35.86166,104.195397
2009,Colombia,0,0,0,0,7,14,21,33.33333333333333,4.570868,-74.297333
2009,Cyprus,0,0,0,0,24,22,46,52.17391304347826,35.126413,33.429859
2009,Denmark,0,0,0,0,5,5,10,50,56.26392,9.501785
2009,Dominican Republic,0,0,0,0,9,3,12,75,18.735693,-70.162651
2009,Ecuador,0,0,0,0,14,21,35,40,-1.831239,-78.183406
2009,Egypt,0,0,0,0,4,4,8,50,26.820553,30.802498
2009,Finland,0,0,0,0,17,20,37,45.94594594594595,61.92411,25.748151
2009,Georgia,0,0,0,0,1,7,8,12.5,42.315407,43.356892
2009,Guatemala,0,0,0,0,2,6,8,25,15.783471,-90.230759
2009,Hungary,0,0,0,0,3,5,8,37.5,47.162494,19.503304
2009,India,0,0,0,0,15,12,27,55.55555555555556,20.593684,78.96288
2009,Indonesia,0,0,0,0,2,6,8,25,-0.789275,113.921327
2009,Ireland,0,0,0,0,5,3,8,62.5,53.41291,-8.24389
2009,Israel,0,0,0,0,22,26,48,45.83333333333333,31.046051,34.851612
2009,Italy,0,0,0,0,80,126,206,38.83495145631068,41.87194,12.56738
2009,Japan,0,0,0,0,9,15,24,37.5,36.204824,138.252924
2009,Kazakhstan,0,0,0,0,33,47,80,41.25,48.019573,66.923684
2009,Kuwait,0,0,0,0,3,6,9,33.33333333333333,29.31166,47.481766
2009,Latvia,0,0,0,0,27,28,55,49.09090909090909,56.879635,24.603189
2009,Lithuania,0,0,0,0,3,5,8,37.5,55.169438,23.881275
2009,Luxembourg,0,0,0,0,5,9,14,35.714285714285715,49.815273,6.129583
2009,Malaysia,0,0,0,0,3,5,8,37.5,4.210484,101.975766
2009,Mexico,0,0,0,0,6,5,11,54.54545454545454,23.634501,-102.552784
2009,Moldova,0,0,0,0,2,6,8,25,47.411631,28.369885
2009,Monaco,0,0,0,0,6,5,11,54.54545454545454,43.750298,7.412841
2009,Montenegro,0,0,0,0,1,4,5,20,42.708678,19.374389999999998
2009,Netherlands,0,0,0,0,7,13,20,35,52.132633,5.291266
2009,New Zealand,0,0,0,0,9,5,14,64.28571428571429,-40.900557,174.885971
2009,Oman,0,0,0,0,1,7,8,12.5,21.512583,55.923255
2009,Pakistan,0,0,0,0,5,3,8,62.5,30.375321,69.345116
2009,Paraguay,0,0,0,0,5,4,9,55.55555555555556,-23.442503,-58.443832
2009,Peru,0,0,0,0,4,8,12,33.33333333333333,-9.189967,-75.015152
2009,Philippines,0,0,0,0,8,4,12,66.66666666666666,12.879721,121.774017
2009,Poland,0,0,0,0,12,17,29,41.37931034482759,51.919438,19.145136
2009,Portugal,0,0,0,0,24,23,47,51.06382978723404,39.399872,-8.224454
2009,Romania,0,0,0,0,36,59,95,37.89473684210527,45.943161,24.96676
2009,Slovakia,0,0,0,0,11,20,31,35.483870967741936,48.669026,19.699024
2009,Slovenia,0,0,0,0,9,7,16,56.25,46.151241,14.995463
2009,South Africa,0,0,0,0,13,18,31,41.935483870967744,-30.559482,22.937506
2009,South Korea,0,0,0,0,4,5,9,44.44444444444444,35.907757,127.766922
2009,Taiwan,0,0,0,0,14,25,39,35.8974358974359,23.69781,120.960515
2009,Thailand,0,0,0,0,3,15,18,16.666666666666664,15.870032,100.992541
2009,Turkey,0,0,0,0,2,3,5,40,38.963745,35.243322
2009,Ukraine,0,0,0,0,23,21,44,52.27272727272727,48.379433,31.16558
2009,Uruguay,0,0,0,0,21,20,41,51.21951219512195,-32.522779,-55.765835
2009,Uzbekistan,0,0,0,0,18,25,43,41.86046511627907,41.377491,64.585262
2009,Venezuela,0,0,0,0,6,6,12,50,6.42375,-66.58973
2010,Australia,0,0,0,0,44,70,114,38.59649122807017,-25.274398,133.775136
2010,Belarus,0,0,0,0,1,11,12,8.333333333333332,53.709807,27.953389
2010,Belgium,0,0,0,0,48,79,127,37.79527559055118,50.503887,4.469936
2010,Bolivia,0,0,0,0,2,6,8,25,-16.290154,-63.588653
2010,Bosnia and Herzegovina,0,0,0,0,8,4,12,66.66666666666666,43.915886,17.679076
2010,Brazil,0,0,0,0,50,57,107,46.728971962616825,-14.235004,-51.92528
2010,Bulgaria,0,0,0,0,3,7,10,30,42.733883,25.48583
2010,Canada,0,0,0,0,12,21,33,36.36363636363637,56.130366,-106.346771
2010,Chile,0,0,0,0,22,24,46,47.82608695652174,-35.675147,-71.542969
2010,China,0,0,0,0,3,10,13,23.076923076923077,35.86166,104.195397
2010,Colombia,0,0,0,0,36,44,80,45,4.570868,-74.297333
2010,Czech Republic,0,0,0,0,80,70,150,53.333333333333336,49.817492,15.472962
2010,Denmark,0,0,0,0,5,4,9,55.55555555555556,56.26392,9.501785
2010,Dominican Republic,0,0,0,0,1,7,8,12.5,18.735693,-70.162651
2010,Ecuador,0,0,0,0,1,17,18,5.555555555555555,-1.831239,-78.183406
2010,Egypt,0,0,0,0,2,7,9,22.22222222222222,26.820553,30.802498
2010,El Salvador,0,0,0,0,3,5,8,37.5,13.794185,-88.89653
2010,Estonia,0,0,0,0,4,4,8,50,58.595272,25.013607
2010,Finland,0,0,0,0,32,33,65,49.23076923076923,61.92411,25.748151
2010,Germany,0,0,0,0,223,271,494,45.1417004048583,51.165691,10.451526
2010,Guatemala,0,0,0,0,2,6,8,25,15.783471,-90.230759
2010,Hungary,0,0,0,0,4,4,8,50,47.162494,19.503304
2010,India,0,0,0,0,11,20,31,35.483870967741936,20.593684,78.96288
2010,Indonesia,0,0,0,0,5,3,8,62.5,-0.789275,113.921327
2010,Ireland,0,0,0,0,6,6,12,50,53.41291,-8.24389
2010,Israel,0,0,0,0,17,28,45,37.77777777777778,31.046051,34.851612
2010,Italy,0,0,0,0,82,118,200,41,41.87194,12.56738
2010,Japan,0,0,0,0,8,18,26,30.76923076923077,36.204824,138.252924
2010,Latvia,0,0,0,0,31,26,57,54.385964912280706,56.879635,24.603189
2010,Lithuania,0,0,0,0,10,9,19,52.63157894736842,55.169438,23.881275
2010,Luxembourg,0,0,0,0,2,2,4,50,49.815273,6.129583
2010,Malaysia,0,0,0,0,2,7,9,22.22222222222222,4.210484,101.975766
2010,Mexico,0,0,0,0,10,3,13,76.92307692307693,23.634501,-102.552784
2010,Monaco,0,0,0,0,6,3,9,66.66666666666666,43.750298,7.412841
2010,Morocco,0,0,0,0,3,3,6,50,31.791702,-7.09262
2010,Netherlands,0,0,0,0,40,42,82,48.78048780487805,52.132633,5.291266
2010,New Zealand,0,0,0,0,10,5,15,66.66666666666666,-40.900557,174.885971
2010,Pakistan,0,0,0,0,3,5,8,37.5,30.375321,69.345116
2010,Paraguay,0,0,0,0,5,6,11,45.45454545454545,-23.442503,-58.443832
2010,Peru,0,0,0,0,5,2,7,71.42857142857143,-9.189967,-75.015152
2010,Philippines,0,0,0,0,3,9,12,25,12.879721,121.774017
2010,Poland,0,0,0,0,19,43,62,30.64516129032258,51.919438,19.145136
2010,Portugal,0,0,0,0,21,19,40,52.5,39.399872,-8.224454
2010,Romania,0,0,0,0,32,32,64,50,45.943161,24.96676
2010,Slovakia,0,0,0,0,23,39,62,37.096774193548384,48.669026,19.699024
2010,Slovenia,0,0,0,0,17,12,29,58.620689655172406,46.151241,14.995463
2010,Solomon Islands,0,0,0,0,2,2,4,50,-9.64571,160.156194
2010,South Africa,0,0,0,0,22,29,51,43.13725490196079,-30.559482,22.937506
2010,South Korea,0,0,0,0,4,9,13,30.76923076923077,35.907757,127.766922
2010,Sri Lanka,0,0,0,0,3,5,8,37.5,7.873054,80.771797
2010,Taiwan,0,0,0,0,18,28,46,39.130434782608695,23.69781,120.960515
2010,Thailand,0,0,0,0,8,5,13,61.53846153846154,15.870032,100.992541
2010,Turkey,0,0,0,0,5,15,20,25,38.963745,35.243322
2010,Ukraine,0,0,0,0,69,72,141,48.93617021276596,48.379433,31.16558
2010,Uruguay,0,0,0,0,23,27,50,46,-32.522779,-55.765835
2010,Uzbekistan,0,0,0,0,33,34,67,49.25373134328358,41.377491,64.585262
2010,Venezuela,0,0,0,0,6,5,11,54.54545454545454,6.42375,-66.58973
2011,Australia,0,0,0,0,39,58,97,40.20618556701031,-25.274398,133.775136
2011,Austria,0,0,0,0,32,50,82,39.02439024390244,47.516231,14.550072
2011,Belarus,0,0,0,0,4,4,8,50,53.709807,27.953389
2011,Belgium,0,0,0,0,49,55,104,47.11538461538461,50.503887,4.469936
2011,Bosnia and Herzegovina,0,0,0,0,6,7,13,46.15384615384615,43.915886,17.679076
2011,Brazil,0,0,0,0,45,60,105,42.857142857142854,-14.235004,-51.92528
2011,Bulgaria,0,0,0,0,21,30,51,41.17647058823529,42.733883,25.48583
2011,Chile,0,0,0,0,5,20,25,20,-35.675147,-71.542969
2011,China,0,0,0,0,5,9,14,35.714285714285715,35.86166,104.195397
2011,Colombia,0,0,0,0,43,47,90,47.77777777777778,4.570868,-74.297333
2011,Cyprus,0,0,0,0,28,33,61,45.90163934426229,35.126413,33.429859
2011,Czech Republic,0,0,0,0,94,77,171,54.97076023391813,49.817492,15.472962
2011,Denmark,0,0,0,0,6,7,13,46.15384615384615,56.26392,9.501785
2011,Dominican Republic,0,0,0,0,5,2,7,71.42857142857143,18.735693,-70.162651
2011,Ecuador,0,0,0,0,5,3,8,62.5,-1.831239,-78.183406
2011,El Salvador,0,0,0,0,2,6,8,25,13.794185,-88.89653
2011,Estonia,0,0,0,0,4,5,9,44.44444444444444,58.595272,25.013607
2011,Finland,0,0,0,0,24,29,53,45.28301886792453,61.92411,25.748151
2011,Greece,0,0,0,0,3,5,8,37.5,39.074208,21.824312
2011,Haiti,0,0,0,0,3,5,8,37.5,18.971187,-72.285215
2011,Hungary,0,0,0,0,7,5,12,58.333333333333336,47.162494,19.503304
2011,India,0,0,0,0,20,32,52,38.46153846153847,20.593684,78.96288
2011,Indonesia,0,0,0,0,3,5,8,37.5,-0.789275,113.921327
2011,Iran,0,0,0,0,3,5,8,37.5,32.427908,53.688046
2011,Ireland,0,0,0,0,5,6,11,45.45454545454545,53.41291,-8.24389
2011,Israel,0,0,0,0,10,17,27,37.03703703703704,31.046051,34.851612
2011,Japan,0,0,0,0,48,37,85,56.470588235294116,36.204824,138.252924
2011,Kazakhstan,0,0,0,0,16,52,68,23.52941176470588,48.019573,66.923684
2011,Latvia,0,0,0,0,23,25,48,47.91666666666667,56.879635,24.603189
2011,Lithuania,0,0,0,0,8,17,25,32,55.169438,23.881275
2011,Luxembourg,0,0,0,0,17,16,33,51.515151515151516,49.815273,6.129583
2011,Mexico,0,0,0,0,3,13,16,18.75,23.634501,-102.552784
2011,Monaco,0,0,0,0,5,6,11,45.45454545454545,43.750298,7.412841
2011,Morocco,0,0,0,0,6,4,10,60,31.791702,-7.09262
2011,Netherlands,0,0,0,0,35,51,86,40.69767441860465,52.132633,5.291266
2011,New Zealand,0,0,0,0,6,4,10,60,-40.900557,174.885971
2011,Pakistan,0,0,0,0,2,5,7,28.57142857142857,30.375321,69.345116
2011,Paraguay,0,0,0,0,6,4,10,60,-23.442503,-58.443832
2011,Peru,0,0,0,0,8,2,10,80,-9.189967,-75.015152
2011,Philippines,0,0,0,0,2,9,11,18.181818181818183,12.879721,121.774017
2011,Poland,0,0,0,0,22,26,48,45.83333333333333,51.919438,19.145136
2011,Portugal,0,0,0,0,18,36,54,33.33333333333333,39.399872,-8.224454
2011,Romania,0,0,0,0,21,39,60,35,45.943161,24.96676
2011,Slovakia,0,0,0,0,13,25,38,34.21052631578947,48.669026,19.699024
2011,Slovenia,0,0,0,0,17,26,43,39.53488372093023,46.151241,14.995463
2011,Solomon Islands,0,0,0,0,1,2,3,33.33333333333333,-9.64571,160.156194
2011,South Africa,0,0,0,0,52,39,91,57.14285714285714,-30.559482,22.937506
2011,South Korea,0,0,0,0,8,2,10,80,35.907757,127.766922
2011,Sweden,0,0,0,0,41,22,63,65.07936507936508,60.128161,18.643501
2011,Syria,0,0,0,0,2,6,8,25,34.802075,38.996815
2011,Taiwan,0,0,0,0,15,26,41,36.58536585365854,23.69781,120.960515
2011,Thailand,0,0,0,0,9,5,14,64.28571428571429,15.870032,100.992541
2011,Tunisia,0,0,0,0,3,7,10,30,33.886917,9.537499
2011,Turkey,0,0,0,0,5,13,18,27.77777777777778,38.963745,35.243322
2011,Uruguay,0,0,0,0,14,18,32,43.75,-32.522779,-55.765835
2011,Uzbekistan,0,0,0,0,13,26,39,33.33333333333333,41.377491,64.585262
2011,Venezuela,0,0,0,0,3,4,7,42.857142857142854,6.42375,-66.58973
2012,Algeria,0,0,0,0,1,1,2,50,28.033886,1.659626
2012,Australia,0,0,0,0,79,91,170,46.470588235294116,-25.274398,133.775136
2012,Austria,0,0,0,0,24,38,62,38.70967741935484,47.516231,14.550072
2012,Barbados,0,0,0,0,2,6,8,25,13.193887,-59.543198
2012,Belarus,0,0,0,0,8,7,15,53.333333333333336,53.709807,27.953389
2012,Belgium,0,0,0,0,74,87,161,45.962732919254655,50.503887,4.469936
2012,Bolivia,0,0,0,0,2,5,7,28.57142857142857,-16.290154,-63.588653
2012,Bosnia and Herzegovina,0,0,0,0,3,5,8,37.5,43.915886,17.679076
2012,Bulgaria,0,0,0,0,26,20,46,56.52173913043478,42.733883,25.48583
2012,Chile,0,0,0,0,6,15,21,28.57142857142857,-35.675147,-71.542969
2012,China,0,0,0,0,5,12,17,29.411764705882355,35.86166,104.195397
2012,Colombia,0,0,0,0,39,51,90,43.333333333333336,4.570868,-74.297333
2012,Cyprus,0,0,0,0,35,31,66,53.03030303030303,35.126413,33.429859
2012,Dominican Republic,0,0,0,0,8,3,11,72.72727272727273,18.735693,-70.162651
2012,Ecuador,0,0,0,0,5,3,8,62.5,-1.831239,-78.183406
2012,Egypt,0,0,0,0,3,5,8,37.5,26.820553,30.802498
2012,El Salvador,0,0,0,0,2,6,8,25,13.794185,-88.89653
2012,Estonia,0,0,0,0,12,14,26,46.15384615384615,58.595272,25.013607
2012,Finland,0,0,0,0,26,33,59,44.06779661016949,61.92411,25.748151
2012,Hungary,0,0,0,0,8,8,16,50,47.162494,19.503304
2012,India,0,0,0,0,7,9,16,43.75,20.593684,78.96288
2012,Indonesia,0,0,0,0,7,5,12,58.333333333333336,-0.789275,113.921327
2012,Ireland,0,0,0,0,4,4,8,50,53.41291,-8.24389
2012,Israel,0,0,0,0,15,21,36,41.66666666666667,31.046051,34.851612
2012,Japan,0,0,0,0,63,62,125,50.4,36.204824,138.252924
2012,Kazakhstan,0,0,0,0,16,26,42,38.095238095238095,48.019573,66.923684
2012,Latvia,0,0,0,0,19,22,41,46.34146341463415,56.879635,24.603189
2012,Lithuania,0,0,0,0,10,5,15,66.66666666666666,55.169438,23.881275
2012,Luxembourg,0,0,0,0,24,26,50,48,49.815273,6.129583
2012,Madagascar,0,0,0,0,1,7,8,12.5,-18.766947,46.869107
2012,Mexico,0,0,0,0,9,6,15,60,23.634501,-102.552784
2012,Moldova,0,0,0,0,3,5,8,37.5,47.411631,28.369885
2012,Monaco,0,0,0,0,3,7,10,30,43.750298,7.412841
2012,Morocco,0,0,0,0,3,7,10,30,31.791702,-7.09262
2012,Netherlands,0,0,0,0,34,43,77,44.15584415584416,52.132633,5.291266
2012,New Zealand,0,0,0,0,2,7,9,22.22222222222222,-40.900557,174.885971
2012,Pakistan,0,0,0,0,2,6,8,25,30.375321,69.345116
2012,Paraguay,0,0,0,0,4,4,8,50,-23.442503,-58.443832
2012,Philippines,0,0,0,0,10,2,12,83.33333333333334,12.879721,121.774017
2012,Poland,0,0,0,0,39,34,73,53.42465753424658,51.919438,19.145136
2012,Portugal,0,0,0,0,17,35,52,32.69230769230769,39.399872,-8.224454
2012,Romania,0,0,0,0,12,36,48,25,45.943161,24.96676
2012,Russia,0,0,0,0,95,151,246,38.61788617886179,61.52401,105.318756
2012,Slovenia,0,0,0,0,22,28,50,44,46.151241,14.995463
2012,South Africa,0,0,0,0,36,37,73,49.31506849315068,-30.559482,22.937506
2012,South Korea,0,0,0,0,3,5,8,37.5,35.907757,127.766922
2012,Sri Lanka,0,0,0,0,4,4,8,50,7.873054,80.771797
2012,Sweden,0,0,0,0,1,11,12,8.333333333333332,60.128161,18.643501
2012,Taiwan,0,0,0,0,17,27,44,38.63636363636363,23.69781,120.960515
2012,Thailand,0,0,0,0,3,8,11,27.27272727272727,15.870032,100.992541
2012,Tunisia,0,0,0,0,6,11,17,35.294117647058826,33.886917,9.537499
2012,Turkey,0,0,0,0,3,7,10,30,38.963745,35.243322
2012,Uruguay,0,0,0,0,4,2,6,66.66666666666666,-32.522779,-55.765835
2012,Uzbekistan,0,0,0,0,33,36,69,47.82608695652174,41.377491,64.585262
2012,Venezuela,0,0,0,0,5,2,7,71.42857142857143,6.42375,-66.58973
2013,Barbados,0,0,0,0,3,4,7,42.857142857142854,13.193887,-59.543198
2013,Belarus,0,0,0,0,3,4,7,42.857142857142854,53.709807,27.953389
2013,Belgium,0,0,0,0,35,63,98,35.714285714285715,50.503887,4.469936
2013,Benin,0,0,0,0,2,6,8,25,9.30769,2.315834
2013,Bosnia and Herzegovina,0,0,0,0,6,6,12,50,43.915886,17.679076
2013,Brazil,0,0,0,0,11,36,47,23.404255319148938,-14.235004,-51.92528
2013,Chile,0,0,0,0,4,10,14,28.57142857142857,-35.675147,-71.542969
2013,China,0,0,0,0,5,9,14,35.714285714285715,35.86166,104.195397
2013,Colombia,0,0,0,0,32,53,85,37.64705882352941,4.570868,-74.297333
2013,Cyprus,0,0,0,0,16,28,44,36.36363636363637,35.126413,33.429859
2013,Dominican Republic,0,0,0,0,5,4,9,55.55555555555556,18.735693,-70.162651
2013,Ecuador,0,0,0,0,5,5,10,50,-1.831239,-78.183406
2013,Egypt,0,0,0,0,1,1,2,50,26.820553,30.802498
2013,El Salvador,0,0,0,0,6,3,9,66.66666666666666,13.794185,-88.89653
2013,Estonia,0,0,0,0,3,10,13,23.076923076923077,58.595272,25.013607
2013,Finland,0,0,0,0,37,33,70,52.85714285714286,61.92411,25.748151
2013,Guatemala,0,0,0,0,4,4,8,50,15.783471,-90.230759
2013,Haiti,0,0,0,0,1,7,8,12.5,18.971187,-72.285215
2013,Hungary,0,0,0,0,3,7,10,30,47.162494,19.503304
2013,India,0,0,0,0,17,20,37,45.94594594594595,20.593684,78.96288
2013,Ireland,0,0,0,0,4,4,8,50,53.41291,-8.24389
2013,Israel,0,0,0,0,6,16,22,27.27272727272727,31.046051,34.851612
2013,Japan,0,0,0,0,53,48,101,52.475247524752476,36.204824,138.252924
2013,Kazakhstan,0,0,0,0,13,16,29,44.827586206896555,48.019573,66.923684
2013,Kuwait,0,0,0,0,3,5,8,37.5,29.31166,47.481766
2013,Latvia,0,0,0,0,39,21,60,65,56.879635,24.603189
2013,Lithuania,0,0,0,0,15,20,35,42.857142857142854,55.169438,23.881275
2013,Luxembourg,0,0,0,0,6,12,18,33.33333333333333,49.815273,6.129583
2013,Mexico,0,0,0,0,5,6,11,45.45454545454545,23.634501,-102.552784
2013,Moldova,0,0,0,0,7,4,11,63.63636363636363,47.411631,28.369885
2013,Monaco,0,0,0,0,3,5,8,37.5,43.750298,7.412841
2013,Netherlands,0,0,0,0,61,66,127,48.031496062992126,52.132633,5.291266
2013,New Zealand,0,0,0,0,10,3,13,76.92307692307693,-40.900557,174.885971
2013,Pakistan,0,0,0,0,3,5,8,37.5,30.375321,69.345116
2013,Peru,0,0,0,0,5,3,8,62.5,-9.189967,-75.015152
2013,Philippines,0,0,0,0,6,6,12,50,12.879721,121.774017
2013,Poland,0,0,0,0,48,54,102,47.05882352941176,51.919438,19.145136
2013,Portugal,0,0,0,0,26,20,46,56.52173913043478,39.399872,-8.224454
2013,Romania,0,0,0,0,23,42,65,35.38461538461539,45.943161,24.96676
2013,Slovakia,0,0,0,0,28,47,75,37.333333333333336,48.669026,19.699024
2013,Slovenia,0,0,0,0,38,55,93,40.86021505376344,46.151241,14.995463
2013,South Africa,0,0,0,0,39,33,72,54.166666666666664,-30.559482,22.937506
2013,South Korea,0,0,0,0,5,5,10,50,35.907757,127.766922
2013,Sri Lanka,0,0,0,0,4,4,8,50,7.873054,80.771797
2013,Sweden,0,0,0,0,3,12,15,20,60.128161,18.643501
2013,Syria,0,0,0,0,4,4,8,50,34.802075,38.996815
2013,Taiwan,0,0,0,0,22,29,51,43.13725490196079,23.69781,120.960515
2013,Thailand,0,0,0,0,4,5,9,44.44444444444444,15.870032,100.992541
2013,Tunisia,0,0,0,0,2,5,7,28.57142857142857,33.886917,9.537499
2013,Ukraine,0,0,0,0,37,51,88,42.04545454545455,48.379433,31.16558
2013,Uruguay,0,0,0,0,4,9,13,30.76923076923077,-32.522779,-55.765835
2013,Uzbekistan,0,0,0,0,34,32,66,51.515151515151516,41.377491,64.585262
2013,Venezuela,0,0,0,0,8,3,11,72.72727272727273,6.42375,-66.58973
2014,Algeria,0,0,0,0,2,1,3,66.66666666666666,28.033886,1.659626
2014,Austria,0,0,0,0,45,57,102,44.11764705882353,47.516231,14.550072
2014,Barbados,0,0,0,0,8,4,12,66.66666666666666,13.193887,-59.543198
2014,Belarus,0,0,0,0,3,6,9,33.33333333333333,53.709807,27.953389
2014,Bolivia,0,0,0,0,3,4,7,42.857142857142854,-16.290154,-63.588653
2014,Bosnia and Herzegovina,0,0,0,0,9,9,18,50,43.915886,17.679076
2014,Brazil,0,0,0,0,22,22,44,50,-14.235004,-51.92528
2014,Chile,0,0,0,0,6,5,11,54.54545454545454,-35.675147,-71.542969
2014,China,0,0,0,0,6,10,16,37.5,35.86166,104.195397
2014,Colombia,0,0,0,0,50,70,120,41.66666666666667,4.570868,-74.297333
2014,Cyprus,0,0,0,0,9,17,26,34.61538461538461,35.126413,33.429859
2014,Denmark,0,0,0,0,9,3,12,75,56.26392,9.501785
2014,Dominican Republic,0,0,0,0,12,13,25,48,18.735693,-70.162651
2014,Ecuador,0,0,0,0,4,3,7,57.14285714285714,-1.831239,-78.183406
2014,Egypt,0,0,0,0,3,6,9,33.33333333333333,26.820553,30.802498
2014,El Salvador,0,0,0,0,3,5,8,37.5,13.794185,-88.89653
2014,Estonia,0,0,0,0,1,2,3,33.33333333333333,58.595272,25.013607
2014,Finland,0,0,0,0,26,31,57,45.614035087719294,61.92411,25.748151
2014,Greece,0,0,0,0,2,5,7,28.57142857142857,39.074208,21.824312
2014,Guatemala,0,0,0,0,3,4,7,42.857142857142854,15.783471,-90.230759
2014,India,0,0,0,0,13,17,30,43.333333333333336,20.593684,78.96288
2014,Indonesia,0,0,0,0,3,5,8,37.5,-0.789275,113.921327
2014,Ireland,0,0,0,0,4,7,11,36.36363636363637,53.41291,-8.24389
2014,Israel,0,0,0,0,19,23,42,45.23809523809524,31.046051,34.851612
2014,Kazakhstan,0,0,0,0,32,64,96,33.33333333333333,48.019573,66.923684
2014,Kuwait,0,0,0,0,4,4,8,50,29.31166,47.481766
2014,Latvia,0,0,0,0,41,29,70,58.57142857142858,56.879635,24.603189
2014,Lithuania,0,0,0,0,15,10,25,60,55.169438,23.881275
2014,Luxembourg,0,0,0,0,6,12,18,33.33333333333333,49.815273,6.129583
2014,Mexico,0,0,0,0,5,9,14,35.714285714285715,23.634501,-102.552784
2014,Moldova,0,0,0,0,10,7,17,58.82352941176471,47.411631,28.369885
2014,Monaco,0,0,0,0,2,3,5,40,43.750298,7.412841
2014,Morocco,0,0,0,0,3,4,7,42.857142857142854,31.791702,-7.09262
2014,Netherlands,0,0,0,0,36,64,100,36,52.132633,5.291266
2014,Pakistan,0,0,0,0,5,7,12,41.66666666666667,30.375321,69.345116
2014,Paraguay,0,0,0,0,2,6,8,25,-23.442503,-58.443832
2014,Peru,0,0,0,0,5,3,8,62.5,-9.189967,-75.015152
2014,Philippines,0,0,0,0,4,3,7,57.14285714285714,12.879721,121.774017
2014,Poland,0,0,0,0,33,59,92,35.869565217391305,51.919438,19.145136
2014,Portugal,0,0,0,0,30,46,76,39.473684210526315,39.399872,-8.224454
2014,Romania,0,0,0,0,20,28,48,41.66666666666667,45.943161,24.96676
2014,Russia,0,0,0,0,76,115,191,39.79057591623037,61.52401,105.318756
2014,Slovakia,0,0,0,0,41,43,84,48.80952380952381,48.669026,19.699024
2014,Slovenia,0,0,0,0,17,29,46,36.95652173913043,46.151241,14.995463
2014,South Africa,0,0,0,0,42,29,71,59.154929577464785,-30.559482,22.937506
2014,South Korea,0,0,0,0,4,2,6,66.66666666666666,35.907757,127.766922
2014,Sri Lanka,0,0,0,0,3,4,7,42.857142857142854,7.873054,80.771797
2014,Sweden,0,0,0,0,3,8,11,27.27272727272727,60.128161,18.643501
2014,Taiwan,0,0,0,0,28,35,63,44.44444444444444,23.69781,120.960515
2014,Thailand,0,0,0,0,9,3,12,75,15.870032,100.992541
2014,Tunisia,0,0,0,0,8,11,19,42.10526315789473,33.886917,9.537499
2014,Ukraine,0,0,0,0,49,47,96,51.041666666666664,48.379433,31.16558
2014,United Kingdom,0,0,0,0,69,46,115,60,55.378051,-3.435973
2014,United States,0,0,0,0,169,206,375,45.06666666666666,37.09024,-95.712891
2014,Uruguay,0,0,0,0,21,16,37,56.75675675675676,-32.522779,-55.765835
2014,Uzbekistan,0,0,0,0,29,33,62,46.774193548387096,41.377491,64.585262
2014,Venezuela,0,0,0,0,2,6,8,25,6.42375,-66.58973
2014,Vietnam,0,0,0,0,4,4,8,50,14.058324,108.277199
2015,Algeria,0,0,0,0,3,4,7,42.857142857142854,28.033886,1.659626
2015,Argentina,0,0,0,0,96,123,219,43.83561643835616,-38.416097,-63.616672
2015,Austria,0,0,0,0,74,76,150,49.333333333333336,47.516231,14.550072
2015,Barbados,0,0,0,0,5,8,13,38.46153846153847,13.193887,-59.543198
2015,Belarus,0,0,0,0,8,5,13,61.53846153846154,53.709807,27.953389
2015,Belgium,0,0,0,0,56,54,110,50.90909090909091,50.503887,4.469936
2015,Bolivia,0,0,0,0,3,4,7,42.857142857142854,-16.290154,-63.588653
2015,Bosnia and Herzegovina,0,0,0,0,11,13,24,45.83333333333333,43.915886,17.679076
2015,Brazil,0,0,0,0,38,56,94,40.42553191489361,-14.235004,-51.92528
2015,Bulgaria,0,0,0,0,40,26,66,60.60606060606061,42.733883,25.48583
2015,Chile,0,0,0,0,13,2,15,86.66666666666667,-35.675147,-71.542969
2015,China,0,0,0,0,8,13,21,38.095238095238095,35.86166,104.195397
2015,Colombia,0,0,0,0,37,55,92,40.21739130434783,4.570868,-74.297333
2015,Cyprus,0,0,0,0,26,19,45,57.77777777777777,35.126413,33.429859
2015,Denmark,0,0,0,0,1,7,8,12.5,56.26392,9.501785
2015,Dominican Republic,0,0,0,0,21,25,46,45.65217391304348,18.735693,-70.162651
2015,Ecuador,0,0,0,0,4,6,10,40,-1.831239,-78.183406
2015,El Salvador,0,0,0,0,4,4,8,50,13.794185,-88.89653
2015,Finland,0,0,0,0,12,22,34,35.294117647058826,61.92411,25.748151
2015,Georgia,0,0,0,0,4,8,12,33.33333333333333,42.315407,43.356892
2015,Hungary,0,0,0,0,9,5,14,64.28571428571429,47.162494,19.503304
2015,India,0,0,0,0,4,9,13,30.76923076923077,20.593684,78.96288
2015,Indonesia,0,0,0,0,4,3,7,57.14285714285714,-0.789275,113.921327
2015,Iran,0,0,0,0,1,6,7,14.285714285714285,32.427908,53.688046
2015,Israel,0,0,0,0,9,15,24,37.5,31.046051,34.851612
2015,Italy,0,0,0,0,101,119,220,45.909090909090914,41.87194,12.56738
2015,Kazakhstan,0,0,0,0,24,41,65,36.92307692307693,48.019573,66.923684
2015,Kuwait,0,0,0,0,4,3,7,57.14285714285714,29.31166,47.481766
2015,Latvia,0,0,0,0,14,29,43,32.55813953488372,56.879635,24.603189
2015,Lebanon,0,0,0,0,1,2,3,33.33333333333333,33.854721,35.862285
2015,Lithuania,0,0,0,0,15,23,38,39.473684210526315,55.169438,23.881275
2015,Luxembourg,0,0,0,0,33,30,63,52.38095238095239,49.815273,6.129583
2015,Madagascar,0,0,0,0,4,4,8,50,-18.766947,46.869107
2015,Mexico,0,0,0,0,2,6,8,25,23.634501,-102.552784
2015,Moldova,0,0,0,0,2,11,13,15.384615384615385,47.411631,28.369885
2015,Monaco,0,0,0,0,2,3,5,40,43.750298,7.412841
2015,Morocco,0,0,0,0,1,3,4,25,31.791702,-7.09262
2015,Netherlands,0,0,0,0,21,42,63,33.33333333333333,52.132633,5.291266
2015,New Zealand,0,0,0,0,5,7,12,41.66666666666667,-40.900557,174.885971
2015,Pakistan,0,0,0,0,7,4,11,63.63636363636363,30.375321,69.345116
2015,Peru,0,0,0,0,2,6,8,25,-9.189967,-75.015152
2015,Philippines,0,0,0,0,4,3,7,57.14285714285714,12.879721,121.774017
2015,Poland,0,0,0,0,27,31,58,46.55172413793103,51.919438,19.145136
2015,Romania,0,0,0,0,10,8,18,55.55555555555556,45.943161,24.96676
2015,Russia,0,0,0,0,51,84,135,37.77777777777778,61.52401,105.318756
2015,Slovakia,0,0,0,0,34,45,79,43.037974683544306,48.669026,19.699024
2015,Slovenia,0,0,0,0,26,39,65,40,46.151241,14.995463
2015,South Korea,0,0,0,0,14,12,26,53.84615384615385,35.907757,127.766922
2015,Sri Lanka,0,0,0,0,3,5,8,37.5,7.873054,80.771797
2015,Sweden,0,0,0,0,5,15,20,25,60.128161,18.643501
2015,Taiwan,0,0,0,0,25,26,51,49.01960784313725,23.69781,120.960515
2015,Thailand,0,0,0,0,1,7,8,12.5,15.870032,100.992541
2015,Tunisia,0,0,0,0,12,20,32,37.5,33.886917,9.537499
2015,Turkey,0,0,0,0,13,19,32,40.625,38.963745,35.243322
2015,Ukraine,0,0,0,0,52,61,113,46.017699115044245,48.379433,31.16558
2015,Uzbekistan,0,0,0,0,23,28,51,45.09803921568628,41.377491,64.585262
2015,Venezuela,0,0,0,0,6,6,12,50,6.42375,-66.58973
2015,Zimbabwe,0,0,0,0,5,3,8,62.5,-19.015438,29.154857
2016,Belarus,0,0,0,0,10,2,12,83.33333333333334,53.709807,27.953389
2016,Belgium,0,0,0,0,56,35,91,61.53846153846154,50.503887,4.469936
2016,Bosnia and Herzegovina,0,0,0,0,31,29,60,51.66666666666667,43.915886,17.679076
2016,Brazil,0,0,0,0,28,45,73,38.35616438356164,-14.235004,-51.92528
2016,Bulgaria,0,0,0,0,41,31,72,56.94444444444444,42.733883,25.48583
2016,Chile,0,0,0,0,6,8,14,42.857142857142854,-35.675147,-71.542969
2016,China,0,0,0,0,8,10,18,44.44444444444444,35.86166,104.195397
2016,Colombia,0,0,0,0,10,20,30,33.33333333333333,4.570868,-74.297333
2016,Cyprus,0,0,0,0,26,23,49,53.06122448979592,35.126413,33.429859
2016,Czech Republic,0,0,0,0,92,85,177,51.9774011299435,49.817492,15.472962
2016,Denmark,0,0,0,0,7,5,12,58.333333333333336,56.26392,9.501785
2016,Dominican Republic,0,0,0,0,12,21,33,36.36363636363637,18.735693,-70.162651
2016,Ecuador,0,0,0,0,5,5,10,50,-1.831239,-78.183406
2016,El Salvador,0,0,0,0,4,3,7,57.14285714285714,13.794185,-88.89653
2016,Estonia,0,0,0,0,1,2,3,33.33333333333333,58.595272,25.013607
2016,Finland,0,0,0,0,5,3,8,62.5,61.92411,25.748151
2016,Georgia,0,0,0,0,6,13,19,31.57894736842105,42.315407,43.356892
2016,Guatemala,0,0,0,0,2,2,4,50,15.783471,-90.230759
2016,Hungary,0,0,0,0,3,6,9,33.33333333333333,47.162494,19.503304
2016,India,0,0,0,0,5,12,17,29.411764705882355,20.593684,78.96288
2016,Indonesia,0,0,0,0,2,2,4,50,-0.789275,113.921327
2016,Israel,0,0,0,0,12,21,33,36.36363636363637,31.046051,34.851612
2016,Kazakhstan,0,0,0,0,15,27,42,35.714285714285715,48.019573,66.923684
2016,Latvia,0,0,0,0,9,20,29,31.03448275862069,56.879635,24.603189
2016,Lithuania,0,0,0,0,13,22,35,37.142857142857146,55.169438,23.881275
2016,Luxembourg,0,0,0,0,35,28,63,55.55555555555556,49.815273,6.129583
2016,Malaysia,0,0,0,0,1,3,4,25,4.210484,101.975766
2016,Mexico,0,0,0,0,2,11,13,15.384615384615385,23.634501,-102.552784
2016,Moldova,0,0,0,0,4,11,15,26.666666666666668,47.411631,28.369885
2016,Monaco,0,0,0,0,2,1,3,66.66666666666666,43.750298,7.412841
2016,Netherlands,0,0,0,0,24,43,67,35.82089552238806,52.132633,5.291266
2016,Norway,0,0,0,0,2,3,5,40,60.472024,8.468946
2016,Peru,0,0,0,0,10,2,12,83.33333333333334,-9.189967,-75.015152
2016,Philippines,0,0,0,0,4,3,7,57.14285714285714,12.879721,121.774017
2016,Poland,0,0,0,0,2,10,12,16.666666666666664,51.919438,19.145136
2016,Portugal,0,0,0,0,38,51,89,42.69662921348314,39.399872,-8.224454
2016,Romania,0,0,0,0,7,12,19,36.84210526315789,45.943161,24.96676
2016,Russia,0,0,0,0,92,119,211,43.60189573459716,61.52401,105.318756
2016,Slovenia,0,0,0,0,15,24,39,38.46153846153847,46.151241,14.995463
2016,South Africa,0,0,0,0,22,24,46,47.82608695652174,-30.559482,22.937506
2016,South Korea,0,0,0,0,10,16,26,38.46153846153847,35.907757,127.766922
2016,Sri Lanka,0,0,0,0,2,2,4,50,7.873054,80.771797
2016,Sweden,0,0,0,0,4,16,20,20,60.128161,18.643501
2016,Taiwan,0,0,0,0,16,11,27,59.25925925925925,23.69781,120.960515
2016,Thailand,0,0,0,0,7,5,12,58.333333333333336,15.870032,100.992541
2016,Tunisia,0,0,0,0,16,24,40,40,33.886917,9.537499
2016,Turkey,0,0,0,0,4,10,14,28.57142857142857,38.963745,35.243322
2016,Ukraine,0,0,0,0,40,56,96,41.66666666666667,48.379433,31.16558
2016,Uzbekistan,0,0,0,0,10,24,34,29.411764705882355,41.377491,64.585262
2016,Venezuela,0,0,0,0,7,5,12,58.333333333333336,6.42375,-66.58973
2016,Vietnam,0,0,0,0,2,6,8,25,14.058324,108.277199
2016,Zimbabwe,0,0,0,0,1,3,4,25,-19.015438,29.154857
2017,Australia,0,0,0,0,81,109,190,42.63157894736842,-25.274398,133.775136
2017,Barbados,0,0,0,0,10,9,19,52.63157894736842,13.193887,-59.543198
2017,Belarus,0,0,0,0,6,5,11,54.54545454545454,53.709807,27.953389
2017,Bolivia,0,0,0,0,2,2,4,50,-16.290154,-63.588653
2017,Brazil,0,0,0,0,38,71,109,34.862385321100916,-14.235004,-51.92528
2017,Canada,0,0,0,0,52,49,101,51.48514851485149,56.130366,-106.346771
2017,Chile,0,0,0,0,5,5,10,50,-35.675147,-71.542969
2017,China,0,0,0,0,8,12,20,40,35.86166,104.195397
2017,Colombia,0,0,0,0,7,15,22,31.818181818181817,4.570868,-74.297333
2017,Cyprus,0,0,0,0,18,20,38,47.368421052631575,35.126413,33.429859
2017,Czech Republic,0,0,0,0,66,58,124,53.2258064516129,49.817492,15.472962
2017,Denmark,0,0,0,0,7,4,11,63.63636363636363,56.26392,9.501785
2017,Dominican Republic,0,0,0,0,8,15,23,34.78260869565217,18.735693,-70.162651
2017,Ecuador,0,0,0,0,5,6,11,45.45454545454545,-1.831239,-78.183406
2017,Egypt,0,0,0,0,1,4,5,20,26.820553,30.802498
2017,El Salvador,0,0,0,0,4,4,8,50,13.794185,-88.89653
2017,Estonia,0,0,0,0,2,4,6,33.33333333333333,58.595272,25.013607
2017,Finland,0,0,0,0,1,3,4,25,61.92411,25.748151
2017,Georgia,0,0,0,0,26,30,56,46.42857142857143,42.315407,43.356892
2017,Greece,0,0,0,0,4,10,14,28.57142857142857,39.074208,21.824312
2017,Guatemala,0,0,0,0,4,3,7,57.14285714285714,15.783471,-90.230759
2017,Hungary,0,0,0,0,10,11,21,47.61904761904761,47.162494,19.503304
2017,India,0,0,0,0,18,11,29,62.06896551724138,20.593684,78.96288
2017,Indonesia,0,0,0,0,1,3,4,25,-0.789275,113.921327
2017,Iran,0,0,0,0,2,2,4,50,32.427908,53.688046
2017,Israel,0,0,0,0,13,20,33,39.39393939393939,31.046051,34.851612
2017,Kazakhstan,0,0,0,0,18,20,38,47.368421052631575,48.019573,66.923684
2017,Kuwait,0,0,0,0,1,2,3,33.33333333333333,29.31166,47.481766
2017,Latvia,0,0,0,0,6,12,18,33.33333333333333,56.879635,24.603189
2017,Lithuania,0,0,0,0,10,15,25,40,55.169438,23.881275
2017,Madagascar,0,0,0,0,2,2,4,50,-18.766947,46.869107
2017,Mexico,0,0,0,0,1,4,5,20,23.634501,-102.552784
2017,Moldova,0,0,0,0,9,17,26,34.61538461538461,47.411631,28.369885
2017,Monaco,0,0,0,0,1,2,3,33.33333333333333,43.750298,7.412841
2017,Morocco,0,0,0,0,3,5,8,37.5,31.791702,-7.09262
2017,Netherlands,0,0,0,0,29,34,63,46.03174603174603,52.132633,5.291266
2017,Norway,0,0,0,0,10,11,21,47.61904761904761,60.472024,8.468946
2017,Pakistan,0,0,0,0,5,3,8,62.5,30.375321,69.345116
2017,Paraguay,0,0,0,0,2,2,4,50,-23.442503,-58.443832
2017,Philippines,0,0,0,0,3,5,8,37.5,12.879721,121.774017
2017,Poland,0,0,0,0,6,11,17,35.294117647058826,51.919438,19.145136
2017,Portugal,0,0,0,0,40,46,86,46.51162790697674,39.399872,-8.224454
2017,Romania,0,0,0,0,9,16,25,36,45.943161,24.96676
2017,Slovakia,0,0,0,0,24,44,68,35.294117647058826,48.669026,19.699024
2017,Slovenia,0,0,0,0,22,25,47,46.808510638297875,46.151241,14.995463
2017,South Africa,0,0,0,0,41,25,66,62.121212121212125,-30.559482,22.937506
2017,South Korea,0,0,0,0,27,20,47,57.446808510638306,35.907757,127.766922
2017,Sweden,0,0,0,0,11,12,23,47.82608695652174,60.128161,18.643501
2017,Taiwan,0,0,0,0,9,20,29,31.03448275862069,23.69781,120.960515
2017,Thailand,0,0,0,0,7,4,11,63.63636363636363,15.870032,100.992541
2017,Tunisia,0,0,0,0,15,24,39,38.46153846153847,33.886917,9.537499
2017,Turkey,0,0,0,0,5,9,14,35.714285714285715,38.963745,35.243322
2017,Uruguay,0,0,0,0,20,21,41,48.78048780487805,-32.522779,-55.765835
2017,Uzbekistan,0,0,0,0,18,22,40,45,41.377491,64.585262
2017,Venezuela,0,0,0,0,7,5,12,58.333333333333336,6.42375,-66.58973
2017,Vietnam,0,0,0,0,2,2,4,50,14.058324,108.277199
2018,Algeria,0,0,0,0,3,2,5,60,28.033886,1.659626
2018,Belarus,0,0,0,0,12,18,30,40,53.709807,27.953389
2018,Belgium,0,0,0,0,35,35,70,50,50.503887,4.469936
2018,Bosnia and Herzegovina,0,0,0,0,39,52,91,42.857142857142854,43.915886,17.679076
2018,Brazil,0,0,0,0,18,31,49,36.734693877551024,-14.235004,-51.92528
2018,Bulgaria,0,0,0,0,24,21,45,53.333333333333336,42.733883,25.48583
2018,Canada,0,0,0,0,85,84,169,50.29585798816568,56.130366,-106.346771
2018,Chile,0,0,0,0,28,26,54,51.85185185185185,-35.675147,-71.542969
2018,China,0,0,0,0,5,11,16,31.25,35.86166,104.195397
2018,Colombia,0,0,0,0,7,6,13,53.84615384615385,4.570868,-74.297333
2018,Cyprus,0,0,0,0,12,17,29,41.37931034482759,35.126413,33.429859
2018,Czech Republic,0,0,0,0,33,36,69,47.82608695652174,49.817492,15.472962
2018,Denmark,0,0,0,0,4,3,7,57.14285714285714,56.26392,9.501785
2018,Dominican Republic,0,0,0,0,3,12,15,20,18.735693,-70.162651
2018,Ecuador,0,0,0,0,2,4,6,33.33333333333333,-1.831239,-78.183406
2018,Egypt,0,0,0,0,7,5,12,58.333333333333336,26.820553,30.802498
2018,El Salvador,0,0,0,0,1,4,5,20,13.794185,-88.89653
2018,Estonia,0,0,0,0,6,8,14,42.857142857142854,58.595272,25.013607
2018,Finland,0,0,0,0,6,6,12,50,61.92411,25.748151
2018,Georgia,0,0,0,0,29,29,58,50,42.315407,43.356892
2018,Guatemala,0,0,0,0,1,2,3,33.33333333333333,15.783471,-90.230759
2018,Hungary,0,0,0,0,27,31,58,46.55172413793103,47.162494,19.503304
2018,India,0,0,0,0,13,26,39,33.33333333333333,20.593684,78.96288
2018,Indonesia,0,0,0,0,1,3,4,25,-0.789275,113.921327
2018,Ireland,0,0,0,0,1,3,4,25,53.41291,-8.24389
2018,Israel,0,0,0,0,9,11,20,45,31.046051,34.851612
2018,Kazakhstan,0,0,0,0,24,28,52,46.15384615384615,48.019573,66.923684
2018,Latvia,0,0,0,0,9,6,15,60,56.879635,24.603189
2018,Lithuania,0,0,0,0,11,18,29,37.93103448275862,55.169438,23.881275
2018,Luxembourg,0,0,0,0,10,22,32,31.25,49.815273,6.129583
2018,Mexico,0,0,0,0,6,6,12,50,23.634501,-102.552784
2018,Moldova,0,0,0,0,12,23,35,34.285714285714285,47.411631,28.369885
2018,Morocco,0,0,0,0,1,4,5,20,31.791702,-7.09262
2018,Netherlands,0,0,0,0,26,35,61,42.62295081967213,52.132633,5.291266
2018,New Zealand,0,0,0,0,1,3,4,25,-40.900557,174.885971
2018,Norway,0,0,0,0,6,12,18,33.33333333333333,60.472024,8.468946
2018,Pakistan,0,0,0,0,4,3,7,57.14285714285714,30.375321,69.345116
2018,Peru,0,0,0,0,4,3,7,57.14285714285714,-9.189967,-75.015152
2018,Philippines,0,0,0,0,4,4,8,50,12.879721,121.774017
2018,Poland,0,0,0,0,12,14,26,46.15384615384615,51.919438,19.145136
2018,Portugal,0,0,0,0,32,39,71,45.07042253521127,39.399872,-8.224454
2018,Romania,0,0,0,0,23,24,47,48.93617021276596,45.943161,24.96676
2018,Slovenia,0,0,0,0,21,29,50,42,46.151241,14.995463
2018,South Korea,0,0,0,0,29,22,51,56.86274509803921,35.907757,127.766922
2018,Sri Lanka,0,0,0,0,1,3,4,25,7.873054,80.771797
2018,Sweden,0,0,0,0,12,15,27,44.44444444444444,60.128161,18.643501
2018,Taiwan,0,0,0,0,4,7,11,36.36363636363637,23.69781,120.960515
2018,Thailand,0,0,0,0,7,5,12,58.333333333333336,15.870032,100.992541
2018,Tunisia,0,0,0,0,22,24,46,47.82608695652174,33.886917,9.537499
2018,Turkey,0,0,0,0,1,5,6,16.666666666666664,38.963745,35.243322
2018,Ukraine,0,0,0,0,8,13,21,38.095238095238095,48.379433,31.16558
2018,Uruguay,0,0,0,0,22,16,38,57.89473684210527,-32.522779,-55.765835
2018,Uzbekistan,0,0,0,0,16,21,37,43.24324324324324,41.377491,64.585262
2018,Venezuela,0,0,0,0,3,4,7,42.857142857142854,6.42375,-66.58973
2018,Zimbabwe,0,0,0,0,3,5,8,37.5,-19.015438,29.154857
2019,Algeria,0,0,0,0,1,1,2,50,28.033886,1.659626
2019,Barbados,0,0,0,0,1,3,4,25,13.193887,-59.543198
2019,Belarus,0,0,0,0,18,19,37,48.64864864864865,53.709807,27.953389
2019,Belgium,0,0,0,0,44,44,88,50,50.503887,4.469936
2019,Bolivia,0,0,0,0,13,17,30,43.333333333333336,-16.290154,-63.588653
2019,Bosnia and Herzegovina,0,0,0,0,14,29,43,32.55813953488372,43.915886,17.679076
2019,Brazil,0,0,0,0,6,19,25,24,-14.235004,-51.92528
2019,Bulgaria,0,0,0,0,24,27,51,47.05882352941176,42.733883,25.48583
2019,China,0,0,0,0,4,17,21,19.047619047619047,35.86166,104.195397
2019,Colombia,0,0,0,0,7,8,15,46.666666666666664,4.570868,-74.297333
2019,Croatia,0,0,0,0,61,63,124,49.193548387096776,45.1,15.2
2019,Cyprus,0,0,0,0,4,3,7,57.14285714285714,35.126413,33.429859
2019,Czech Republic,0,0,0,0,25,26,51,49.01960784313725,49.817492,15.472962
2019,Denmark,0,0,0,0,1,4,5,20,56.26392,9.501785
2019,Dominican Republic,0,0,0,0,1,2,3,33.33333333333333,18.735693,-70.162651
2019,Egypt,0,0,0,0,1,3,4,25,26.820553,30.802498
2019,El Salvador,0,0,0,0,2,2,4,50,13.794185,-88.89653
2019,Finland,0,0,0,0,2,2,4,50,61.92411,25.748151
2019,Georgia,0,0,0,0,29,26,55,52.72727272727272,42.315407,43.356892
2019,Guatemala,0,0,0,0,1,3,4,25,15.783471,-90.230759
2019,Hungary,0,0,0,0,30,34,64,46.875,47.162494,19.503304
2019,India,0,0,0,0,7,22,29,24.137931034482758,20.593684,78.96288
2019,Indonesia,0,0,0,0,1,2,3,33.33333333333333,-0.789275,113.921327
2019,Japan,0,0,0,0,69,66,135,51.11111111111111,36.204824,138.252924
2019,Kazakhstan,0,0,0,0,37,41,78,47.43589743589743,48.019573,66.923684
2019,Latvia,0,0,0,0,6,17,23,26.08695652173913,56.879635,24.603189
2019,Lithuania,0,0,0,0,10,13,23,43.47826086956522,55.169438,23.881275
2019,Mexico,0,0,0,0,4,2,6,66.66666666666666,23.634501,-102.552784
2019,Moldova,0,0,0,0,31,26,57,54.385964912280706,47.411631,28.369885
2019,Netherlands,0,0,0,0,16,23,39,41.02564102564102,52.132633,5.291266
2019,New Zealand,0,0,0,0,2,2,4,50,-40.900557,174.885971
2019,Norway,0,0,0,0,22,18,40,55.00000000000001,60.472024,8.468946
2019,Peru,0,0,0,0,2,2,4,50,-9.189967,-75.015152
2019,Philippines,0,0,0,0,1,2,3,33.33333333333333,12.879721,121.774017
2019,Poland,0,0,0,0,28,30,58,48.275862068965516,51.919438,19.145136
2019,Portugal,0,0,0,0,28,42,70,40,39.399872,-8.224454
2019,Romania,0,0,0,0,10,20,30,33.33333333333333,45.943161,24.96676
2019,Slovakia,0,0,0,0,16,36,52,30.76923076923077,48.669026,19.699024
2019,Slovenia,0,0,0,0,20,20,40,50,46.151241,14.995463
2019,South Africa,0,0,0,0,22,18,40,55.00000000000001,-30.559482,22.937506
2019,South Korea,0,0,0,0,15,16,31,48.38709677419355,35.907757,127.766922
2019,Sweden,0,0,0,0,7,12,19,36.84210526315789,60.128161,18.643501
2019,Taiwan,0,0,0,0,5,7,12,41.66666666666667,23.69781,120.960515
2019,Thailand,0,0,0,0,2,1,3,66.66666666666666,15.870032,100.992541
2019,Tunisia,0,0,0,0,6,17,23,26.08695652173913,33.886917,9.537499
2019,Turkey,0,0,0,0,4,5,9,44.44444444444444,38.963745,35.243322
2019,Ukraine,0,0,0,0,5,8,13,38.46153846153847,48.379433,31.16558
2019,Uruguay,0,0,0,0,24,24,48,50,-32.522779,-55.765835
2019,Uzbekistan,0,0,0,0,6,16,22,27.27272727272727,41.377491,64.585262
2019,Zimbabwe,0,0,0,0,1,3,4,25,-19.015438,29.154857
2020,Argentina,0,0,0,0,61,75,136,44.85294117647059,-38.416097,-63.616672
2020,Belarus,0,0,0,0,16,16,32,50,53.709807,27.953389
2020,Belgium,0,0,0,0,16,18,34,47.05882352941176,50.503887,4.469936
2020,Bolivia,0,0,0,0,4,8,12,33.33333333333333,-16.290154,-63.588653
2020,Bosnia and Herzegovina,0,0,0,0,2,9,11,18.181818181818183,43.915886,17.679076
2020,Brazil,0,0,0,0,14,14,28,50,-14.235004,-51.92528
2020,Bulgaria,0,0,0,0,24,14,38,63.1578947368421,42.733883,25.48583
2020,Canada,0,0,0,0,80,58,138,57.971014492753625,56.130366,-106.346771
2020,Chile,0,0,0,0,22,20,42,52.38095238095239,-35.675147,-71.542969
2020,Colombia,0,0,0,0,4,4,8,50,4.570868,-74.297333
2020,Croatia,0,0,0,0,33,29,62,53.2258064516129,45.1,15.2
2020,Czech Republic,0,0,0,0,14,9,23,60.86956521739131,49.817492,15.472962
2020,Dominican Republic,0,0,0,0,1,2,3,33.33333333333333,18.735693,-70.162651
2020,Ecuador,0,0,0,0,2,3,5,40,-1.831239,-78.183406
2020,Egypt,0,0,0,0,1,6,7,14.285714285714285,26.820553,30.802498
2020,El Salvador,0,0,0,0,2,1,3,66.66666666666666,13.794185,-88.89653
2020,Estonia,0,0,0,0,3,1,4,75,58.595272,25.013607
2020,Finland,0,0,0,0,8,11,19,42.10526315789473,61.92411,25.748151
2020,Georgia,0,0,0,0,5,18,23,21.73913043478261,42.315407,43.356892
2020,Guatemala,0,0,0,0,1,2,3,33.33333333333333,15.783471,-90.230759
2020,Hungary,0,0,0,0,20,17,37,54.054054054054056,47.162494,19.503304
2020,India,0,0,0,0,2,13,15,13.333333333333334,20.593684,78.96288
2020,Israel,0,0,0,0,2,1,3,66.66666666666666,31.046051,34.851612
2020,Japan,0,0,0,0,25,38,63,39.682539682539684,36.204824,138.252924
2020,Kazakhstan,0,0,0,0,20,27,47,42.5531914893617,48.019573,66.923684
2020,Latvia,0,0,0,0,4,2,6,66.66666666666666,56.879635,24.603189
2020,Lithuania,0,0,0,0,7,10,17,41.17647058823529,55.169438,23.881275
2020,Mexico,0,0,0,0,2,3,5,40,23.634501,-102.552784
2020,Moldova,0,0,0,0,7,16,23,30.434782608695656,47.411631,28.369885
2020,Netherlands,0,0,0,0,1,5,6,16.666666666666664,52.132633,5.291266
2020,New Zealand,0,0,0,0,2,2,4,50,-40.900557,174.885971
2020,Peru,0,0,0,0,3,2,5,60,-9.189967,-75.015152
2020,Poland,0,0,0,0,19,18,37,51.35135135135135,51.919438,19.145136
2020,Portugal,0,0,0,0,8,14,22,36.36363636363637,39.399872,-8.224454
2020,Russia,0,0,0,0,94,46,140,67.14285714285714,61.52401,105.318756
2020,Slovakia,0,0,0,0,12,29,41,29.268292682926827,48.669026,19.699024
2020,Slovenia,0,0,0,0,10,14,24,41.66666666666667,46.151241,14.995463
2020,South Africa,0,0,0,0,22,23,45,48.888888888888886,-30.559482,22.937506
2020,South Korea,0,0,0,0,8,7,15,53.333333333333336,35.907757,127.766922
2020,Sweden,0,0,0,0,6,8,14,42.857142857142854,60.128161,18.643501
2020,Switzerland,0,0,0,0,27,18,45,60,46.818188,8.227512
2020,Taiwan,0,0,0,0,5,10,15,33.33333333333333,23.69781,120.960515
2020,Thailand,0,0,0,0,1,2,3,33.33333333333333,15.870032,100.992541
2020,Tunisia,0,0,0,0,2,3,5,40,33.886917,9.537499
2020,Turkey,0,0,0,0,2,3,5,40,38.963745,35.243322
2020,Ukraine,0,0,0,0,2,5,7,28.57142857142857,48.379433,31.16558
2020,United Kingdom,0,0,0,0,41,41,82,50,55.378051,-3.435973
2020,Uruguay,0,0,0,0,8,18,26,30.76923076923077,-32.522779,-55.765835
2020,Venezuela,0,0,0,0,1,2,3,33.33333333333333,6.42375,-66.58973
2020,Zimbabwe,0,0,0,0,2,1,3,66.66666666666666,-19.015438,29.154857
2021,Australia,0,0,0,0,61,67,128,47.65625,-25.274398,133.775136
2021,Austria,0,0,0,0,8,10,18,44.44444444444444,47.516231,14.550072
2021,Belarus,0,0,0,0,13,13,26,50,53.709807,27.953389
2021,Belgium,0,0,0,0,13,11,24,54.166666666666664,50.503887,4.469936
2021,Bosnia and Herzegovina,0,0,0,0,1,3,4,25,43.915886,17.679076
2021,Brazil,0,0,0,0,9,10,19,47.368421052631575,-14.235004,-51.92528
2021,Bulgaria,0,0,0,0,13,8,21,61.904761904761905,42.733883,25.48583
2021,Canada,0,0,0,0,28,22,50,56.00000000000001,56.130366,-106.346771
2021,Chile,0,0,0,0,8,11,19,42.10526315789473,-35.675147,-71.542969
2021,Colombia,0,0,0,0,6,5,11,54.54545454545454,4.570868,-74.297333
2021,Croatia,0,0,0,0,12,11,23,52.17391304347826,45.1,15.2
2021,Czech Republic,0,0,0,0,6,9,15,40,49.817492,15.472962
2021,Denmark,0,0,0,0,3,7,10,30,56.26392,9.501785
2021,Ecuador,0,0,0,0,2,1,3,66.66666666666666,-1.831239,-78.183406
2021,Finland,0,0,0,0,8,6,14,57.14285714285714,61.92411,25.748151
2021,France,0,0,0,0,61,82,143,42.65734265734265,46.227638,2.213749
2021,Georgia,0,0,0,0,9,10,19,47.368421052631575,42.315407,43.356892
2021,Germany,0,0,0,0,32,35,67,47.76119402985074,51.165691,10.451526
2021,Hungary,0,0,0,0,13,9,22,59.09090909090909,47.162494,19.503304
2021,India,0,0,0,0,2,9,11,18.181818181818183,20.593684,78.96288
2021,Japan,0,0,0,0,17,28,45,37.77777777777778,36.204824,138.252924
2021,Kazakhstan,0,0,0,0,18,16,34,52.94117647058824,48.019573,66.923684
2021,Lithuania,0,0,0,0,5,5,10,50,55.169438,23.881275
2021,Moldova,0,0,0,0,5,6,11,45.45454545454545,47.411631,28.369885
2021,Netherlands,0,0,0,0,6,9,15,40,52.132633,5.291266
2021,Norway,0,0,0,0,10,5,15,66.66666666666666,60.472024,8.468946
2021,Peru,0,0,0,0,2,1,3,66.66666666666666,-9.189967,-75.015152
2021,Poland,0,0,0,0,16,9,25,64,51.919438,19.145136
2021,Portugal,0,0,0,0,3,13,16,18.75,39.399872,-8.224454
2021,Slovakia,0,0,0,0,8,18,26,30.76923076923077,48.669026,19.699024
2021,Slovenia,0,0,0,0,9,8,17,52.94117647058824,46.151241,14.995463
2021,South Africa,0,0,0,0,11,9,20,55.00000000000001,-30.559482,22.937506
2021,South Korea,0,0,0,0,6,9,15,40,35.907757,127.766922
2021,Sweden,0,0,0,0,4,6,10,40,60.128161,18.643501
2021,Switzerland,0,0,0,0,4,9,13,30.76923076923077,46.818188,8.227512
2021,Taiwan,0,0,0,0,1,4,5,20,23.69781,120.960515
2021,Tunisia,0,0,0,0,2,3,5,40,33.886917,9.537499
2021,Turkey,0,0,0,0,2,4,6,33.33333333333333,38.963745,35.243322
2021,Ukraine,0,0,0,0,1,2,3,33.33333333333333,48.379433,31.16558
2021,United Kingdom,0,0,0,0,26,20,46,56.52173913043478,55.378051,-3.435973
2021,United States,0,0,0,0,64,77,141,45.39007092198582,37.09024,-95.712891
2021,Uruguay,0,0,0,0,3,2,5,60,-32.522779,-55.765835
