country_name,wins,runnerups,total_finals_games,finals_win_rate,total_wins,total_losses,total_games,win_rate,Czechia,latitude,longitude
Argentina,235,222,457,51.42231947483589,7989,7117,15106,52.88627035614988,Czech Republic,-38.416097,-63.616672
Armenia,1,2,3,33.33333333333333,158,220,378,41.7989417989418,Czech Republic,40.069099,45.038189
Australia,290,325,615,47.15447154471545,13965,13577,27542,50.70437876697408,Czech Republic,-25.274398,133.775136
Austria,79,52,131,60.30534351145038,2610,2649,5259,49.629207073588134,Czech Republic,47.516231,14.550072
Belarus,1,5,6,16.666666666666664,440,478,918,47.930283224400874,Czech Republic,53.709807,27.953389
Belgium,16,34,50,32,1830,2215,4045,45.24103831891224,Czech Republic,50.503887,4.469936
Bolivia,3,1,4,75,179,293,472,37.92372881355932,Czech Republic,-16.290154,-63.588653
Bosnia & Herzegovina,4,1,5,80,200,247,447,44.742729306487696,Czech Republic,NA,NA
Brazil,42,37,79,53.16455696202531,2211,2799,5010,44.131736526946106,Czech Republic,-14.235004,-51.92528
Bulgaria,8,7,15,53.333333333333336,493,457,950,51.89473684210526,Czech Republic,42.733883,25.48583
Canada,9,31,40,22.5,1539,1933,3472,44.326036866359445,Czech Republic,56.130366,-106.346771
Chile,57,54,111,51.35135135135135,2574,2390,4964,51.853344077356965,Czech Republic,-35.675147,-71.542969
Colombia,1,8,9,11.11111111111111,707,987,1694,41.735537190082646,Czech Republic,4.570868,-74.297333
Costa Rica,1,1,2,50,89,160,249,35.7429718875502,Czech Republic,9.748917,-83.753428
Croatia,86,99,185,46.48648648648649,3494,2843,6337,55.13649992109831,Czech Republic,45.1,15.2
Cyprus,4,10,14,28.57142857142857,355,371,726,48.89807162534435,Czech Republic,35.126413,33.429859
Czech Republic,92,146,238,38.655462184873954,5662,5667,11329,49.977932738988436,Czech Republic,49.817492,15.472962
Denmark,4,5,9,44.44444444444444,609,822,1431,42.55765199161425,Czech Republic,56.26392,9.501785
Ecuador,26,22,48,54.166666666666664,1127,986,2113,53.33648840511122,Czech Republic,-1.831239,-78.183406
Egypt,1,1,2,50,417,499,916,45.5240174672489,Czech Republic,26.820553,30.802498
Finland,2,12,14,14.285714285714285,692,770,1462,47.332421340629274,Czech Republic,61.92411,25.748151
France,171,251,422,40.52132701421801,11357,11895,23252,48.843110270084296,Czech Republic,46.227638,2.213749
Georgia,4,2,6,66.66666666666666,173,263,436,39.678899082568805,Czech Republic,42.315407,43.356892
Germany,163,193,356,45.78651685393258,8749,9550,18299,47.81135581179299,Czech Republic,51.165691,10.451526
Greece,7,10,17,41.17647058823529,320,364,684,46.783625730994146,Czech Republic,39.074208,21.824312
Hungary,14,13,27,51.85185185185185,952,953,1905,49.973753280839894,Czech Republic,47.162494,19.503304
India,24,17,41,58.536585365853654,1342,1666,3008,44.61436170212766,Czech Republic,20.593684,78.96288
Israel,8,21,29,27.586206896551722,980,1137,2117,46.291922531884744,Czech Republic,31.046051,34.851612
Italy,73,112,185,39.45945945945946,5024,6132,11156,45.03406238795267,Czech Republic,41.87194,12.56738
Japan,16,20,36,44.44444444444444,1323,1695,3018,43.836978131212724,Czech Republic,36.204824,138.252924
Kazakhstan,2,10,12,16.666666666666664,417,573,990,42.12121212121212,Czech Republic,48.019573,66.923684
Latvia,6,1,7,85.71428571428571,312,348,660,47.27272727272727,Czech Republic,56.879635,24.603189
Luxembourg,2,6,8,25,299,393,692,43.20809248554913,Czech Republic,49.815273,6.129583
Mexico,21,25,46,45.65217391304348,1155,1161,2316,49.870466321243526,Czech Republic,23.634501,-102.552784
Morocco,8,17,25,32,743,810,1553,47.842884739214426,Czech Republic,31.791702,-7.09262
Netherlands,68,64,132,51.515151515151516,3148,3188,6336,49.68434343434344,Czech Republic,52.132633,5.291266
New Zealand,15,28,43,34.883720930232556,1551,1794,3345,46.36771300448431,Czech Republic,-40.900557,174.885971
Norway,1,3,4,25,295,381,676,43.63905325443787,Czech Republic,60.472024,8.468946
Pakistan,2,6,8,25,328,363,691,47.467438494934875,Czech Republic,30.375321,69.345116
Paraguay,10,15,25,40,670,653,1323,50.64247921390779,Czech Republic,-23.442503,-58.443832
Peru,12,11,23,52.17391304347826,759,826,1585,47.88643533123028,Czech Republic,-9.189967,-75.015152
Poland,18,25,43,41.86046511627907,1020,903,1923,53.042121684867396,Czech Republic,51.919438,19.145136
Portugal,3,9,12,25,515,782,1297,39.707016191210485,Czech Republic,39.399872,-8.224454
Romania,67,53,120,55.833333333333336,1978,1761,3739,52.90184541321209,Czech Republic,45.943161,24.96676
Russia,133,105,238,55.88235294117647,4796,4125,8921,53.760789149198516,Czech Republic,61.52401,105.318756
Serbia,98,57,155,63.2258064516129,2062,1428,3490,59.08309455587393,Czech Republic,44.016521,21.005859
Slovakia,36,35,71,50.70422535211267,1508,1533,3041,49.588951002959554,Czech Republic,48.669026,19.699024
South Africa,45,66,111,40.54054054054054,3868,4343,8211,47.107538667640966,Czech Republic,-30.559482,22.937506
South Korea,2,1,3,66.66666666666666,457,494,951,48.0546792849632,Czech Republic,35.907757,127.766922
Spain,431,390,821,52.496954933008524,14949,12994,27943,53.49819274952582,Czech Republic,40.463667,-3.74922
Sweden,287,224,511,56.16438356164384,8227,6753,14980,54.91989319092123,Czech Republic,60.128161,18.643501
Switzerland,146,96,242,60.33057851239669,3447,2436,5883,58.59255481896991,Czech Republic,46.818188,8.227512
Thailand,5,6,11,45.45454545454545,450,435,885,50.847457627118644,Czech Republic,15.870032,100.992541
Ukraine,19,13,32,59.375,866,850,1716,50.46620046620046,Czech Republic,48.379433,31.16558
United Kingdom,100,92,192,52.083333333333336,4530,4486,9016,50.244010647737355,Czech Republic,55.378051,-3.435973
United States,1066,964,2030,52.51231527093596,36816,33066,69882,52.68309435906242,Czech Republic,37.09024,-95.712891
Uruguay,12,10,22,54.54545454545454,855,902,1757,48.66249288560046,Czech Republic,-32.522779,-55.765835
Uzbekistan,2,3,5,40,319,399,718,44.428969359331475,Czech Republic,41.377491,64.585262
Zimbabwe,2,10,12,16.666666666666664,480,569,1049,45.7578646329838,Czech Republic,-19.015438,29.154857
Algeria,0,0,0,0,50,110,160,31.25,Czech Republic,28.033886,1.659626
Andorra,0,0,0,0,3,5,8,37.5,Czech Republic,42.546245,1.601554
Austria-Hungary,0,0,0,0,113,155,268,42.16417910447761,Czech Republic,NA,NA
Baden,0,0,0,0,113,155,268,42.16417910447761,Czech Republic,NA,NA
Bahamas,0,0,0,0,117,228,345,33.91304347826087,Czech Republic,25.03428,-77.39628
Bahrain,0,0,0,0,9,19,28,32.142857142857146,Czech Republic,25.930414,50.637772
Bangladesh,0,0,0,0,10,34,44,22.727272727272727,Czech Republic,23.684994,90.356331
Barbados,0,0,0,0,31,65,96,32.29166666666667,Czech Republic,13.193887,-59.543198
Bavaria,0,0,0,0,113,155,268,42.16417910447761,Czech Republic,NA,NA
Benin,0,0,0,0,2,7,9,22.22222222222222,Czech Republic,9.30769,2.315834
Brunswick,0,0,0,0,113,155,268,42.16417910447761,Czech Republic,NA,NA
Cameroon,0,0,0,0,6,14,20,30,Czech Republic,7.369722,12.354722
China,0,0,0,0,189,300,489,38.65030674846626,Czech Republic,35.86166,104.195397
Côte d’Ivoire,0,0,0,0,77,86,163,47.239263803680984,Czech Republic,NA,NA
Cuba,0,0,0,0,68,87,155,43.87096774193549,Czech Republic,21.521757,-77.781167
Czechoslovakia,0,0,0,0,113,155,268,42.16417910447761,Czech Republic,NA,NA
Dominican Republic,0,0,0,0,140,172,312,44.871794871794876,Czech Republic,18.735693,-70.162651
El Salvador,0,0,0,0,45,69,114,39.473684210526315,Czech Republic,13.794185,-88.89653
Estonia,0,0,0,0,51,85,136,37.5,Czech Republic,58.595272,25.013607
German Democratic Republic,0,0,0,0,113,155,268,42.16417910447761,Czech Republic,NA,NA
Ghana,0,0,0,0,43,58,101,42.57425742574257,Czech Republic,7.946527,-1.023194
Guatemala,0,0,0,0,44,80,124,35.483870967741936,Czech Republic,15.783471,-90.230759
Haiti,0,0,0,0,18,57,75,24,Czech Republic,18.971187,-72.285215
Hamburg,0,0,0,0,113,155,268,42.16417910447761,Czech Republic,NA,NA
Hanover,0,0,0,0,113,155,268,42.16417910447761,Czech Republic,NA,NA
Hesse Electoral,0,0,0,0,113,155,268,42.16417910447761,Czech Republic,NA,NA
Hesse Grand Ducal,0,0,0,0,113,155,268,42.16417910447761,Czech Republic,NA,NA
Hesse-Darmstadt,0,0,0,0,113,155,268,42.16417910447761,Czech Republic,NA,NA
Hesse-Kassel,0,0,0,0,113,155,268,42.16417910447761,Czech Republic,NA,NA
Hong Kong SAR China,0,0,0,0,110,156,266,41.35338345864661,Czech Republic,NA,NA
Indonesia,0,0,0,0,157,250,407,38.57493857493858,Czech Republic,-0.789275,113.921327
Iran,0,0,0,0,120,179,299,40.13377926421405,Czech Republic,32.427908,53.688046
Iraq,0,0,0,0,4,8,12,33.33333333333333,Czech Republic,33.223191,43.679291
Ireland,0,0,0,0,233,356,589,39.55857385398981,Czech Republic,53.41291,-8.24389
Jamaica,0,0,0,0,56,153,209,26.794258373205743,Czech Republic,18.109581,-77.297508
Jordan,0,0,0,0,7,21,28,25,Czech Republic,30.585164,36.238414
Kenya,0,0,0,0,42,84,126,33.33333333333333,Czech Republic,-0.023559,37.906193
Kuwait,0,0,0,0,63,89,152,41.44736842105263,Czech Republic,29.31166,47.481766
Lebanon,0,0,0,0,5,2,7,71.42857142857143,Czech Republic,33.854721,35.862285
Lithuania,0,0,0,0,141,189,330,42.72727272727273,Czech Republic,55.169438,23.881275
Madagascar,0,0,0,0,7,13,20,35,Czech Republic,-18.766947,46.869107
Malaysia,0,0,0,0,46,143,189,24.33862433862434,Czech Republic,4.210484,101.975766
Malta,0,0,0,0,3,37,40,7.5,Czech Republic,35.937496,14.375416
Marshall Islands,0,0,0,0,4,3,7,57.14285714285714,Czech Republic,7.131474,171.184478
Mecklenburg Schwerin,0,0,0,0,113,155,268,42.16417910447761,Czech Republic,NA,NA
Modena,0,0,0,0,113,155,268,42.16417910447761,Czech Republic,NA,NA
Moldova,0,0,0,0,97,147,244,39.75409836065574,Czech Republic,47.411631,28.369885
Monaco,0,0,0,0,164,259,423,38.77068557919622,Czech Republic,43.750298,7.412841
Montenegro,0,0,0,0,1,4,5,20,Czech Republic,42.708678,19.374389999999998
Nassau,0,0,0,0,113,155,268,42.16417910447761,Czech Republic,NA,NA
Niger,0,0,0,0,2,6,8,25,Czech Republic,17.607789,8.081666
Nigeria,0,0,0,0,142,221,363,39.11845730027548,Czech Republic,9.081999,8.675277
North Macedonia,0,0,0,0,19,47,66,28.78787878787879,Czech Republic,NA,NA
Oldenburg,0,0,0,0,113,155,268,42.16417910447761,Czech Republic,NA,NA
Oman,0,0,0,0,3,13,16,18.75,Czech Republic,21.512583,55.923255
Orange Free State,0,0,0,0,113,155,268,42.16417910447761,Czech Republic,NA,NA
Parma,0,0,0,0,113,155,268,42.16417910447761,Czech Republic,NA,NA
Philippines,0,0,0,0,227,344,571,39.754816112084065,Czech Republic,12.879721,121.774017
Piedmont-Sardinia,0,0,0,0,113,155,268,42.16417910447761,Czech Republic,NA,NA
Prussia,0,0,0,0,113,155,268,42.16417910447761,Czech Republic,NA,NA
Qatar,0,0,0,0,4,45,49,8.16326530612245,Czech Republic,25.354826,51.183884
Republic of Vietnam,0,0,0,0,113,155,268,42.16417910447761,Czech Republic,NA,NA
Samoa,0,0,0,0,3,10,13,23.076923076923077,Czech Republic,-13.759029,-172.104629
Sardinia,0,0,0,0,113,155,268,42.16417910447761,Czech Republic,NA,NA
Saudi Arabia,0,0,0,0,7,21,28,25,Czech Republic,23.885942,45.079162
Saxe-Weimar-Eisenach,0,0,0,0,113,155,268,42.16417910447761,Czech Republic,NA,NA
Saxony,0,0,0,0,113,155,268,42.16417910447761,Czech Republic,NA,NA
Senegal,0,0,0,0,52,97,149,34.899328859060404,Czech Republic,14.497401,-14.452362
Serbia and Montenegro,0,0,0,0,113,155,268,42.16417910447761,Czech Republic,NA,NA
Slovenia,0,0,0,0,327,387,714,45.79831932773109,Czech Republic,46.151241,14.995463
Solomon Islands,0,0,0,0,11,14,25,44,Czech Republic,-9.64571,160.156194
Somaliland,0,0,0,0,113,155,268,42.16417910447761,Czech Republic,NA,NA
Sri Lanka,0,0,0,0,73,124,197,37.055837563451774,Czech Republic,7.873054,80.771797
Syria,0,0,0,0,11,38,49,22.448979591836736,Czech Republic,34.802075,38.996815
Taiwan,0,0,0,0,342,489,831,41.15523465703971,Czech Republic,23.69781,120.960515
Tajikistan,0,0,0,0,1,7,8,12.5,Czech Republic,38.861034,71.276093
Togo,0,0,0,0,8,20,28,28.57142857142857,Czech Republic,8.619543,0.824782
Tunisia,0,0,0,0,105,200,305,34.42622950819672,Czech Republic,33.886917,9.537499
Turkey,0,0,0,0,85,216,301,28.23920265780731,Czech Republic,38.963745,35.243322
Tuscany,0,0,0,0,113,155,268,42.16417910447761,Czech Republic,NA,NA
Two Sicilies,0,0,0,0,113,155,268,42.16417910447761,Czech Republic,NA,NA
United Arab Emirates,0,0,0,0,37,16,53,69.81132075471697,Czech Republic,23.424076,53.847818
United Province CA,0,0,0,0,113,155,268,42.16417910447761,Czech Republic,NA,NA
Vatican City,0,0,0,0,113,155,268,42.16417910447761,Czech Republic,41.902916,12.453389
Venezuela,0,0,0,0,316,514,830,38.0722891566265,Czech Republic,6.42375,-66.58973
Vietnam,0,0,0,0,27,35,62,43.54838709677419,Czech Republic,14.058324,108.277199
Wuerttemburg,0,0,0,0,113,155,268,42.16417910447761,Czech Republic,NA,NA
Würtemberg,0,0,0,0,113,155,268,42.16417910447761,Czech Republic,NA,NA
Yemen Arab Republic,0,0,0,0,113,155,268,42.16417910447761,Czech Republic,NA,NA
Yemen People's Republic,0,0,0,0,113,155,268,42.16417910447761,Czech Republic,NA,NA
Yugoslavia,0,0,0,0,113,155,268,42.16417910447761,Czech Republic,NA,NA
Zambia,0,0,0,0,7,13,20,35,Czech Republic,-13.133897,27.849332
Zanzibar,0,0,0,0,113,155,268,42.16417910447761,Czech Republic,NA,NA
